# Menu
User = Benutzer
Join... = Mitglied werden…
Login... = Einloggen…
Log in = Einloggen
Logout = Ausloggen
Change password... = Passwort ändern…
User Preference = Benutzereingestellungen
System Settings... = Systemeinstellungen...
System Settings = Systemeinstellungen
Crash = Absturz
Invite friends... = Freunde einladen…
Language = Sprache
Language Setting = Spracheinstellungen

Document Recovery = Dokument Wiederherstellung
Your Preferences Information = Ihre Einstellungs Informationen
File = Datei
New = Neu
Project... = Projekt…
Schematic = Schaltplan
Schematic-Simulation = Schaltplansimulation
Spice Symbol = Spice Schaltsymbol
Spice Subckt = Spice (Unter)Schaltsymbol
spicePre = spiceVorsilbe
PCB = PCB
Schematic Module = Schaltplanmodul
PCB Module = PCB-Modul
Save... = Speichern…
Save As... = Speichern unter…
Save As Module... = Speichern als Modul
Print = Drucken
Export Document = Dokument exportieren
LTspice... = LTspice…
Eagle... = Eagle…
Altium... = Altium…
Cadence... = Cadence…
Pads... = Pads…
DXF = DXF
Import = Importieren

Edit = Bearbeiten
Undo = Rückgängig
Redo = Wiederherstellen
Cut = Ausschneiden
Copy = Kopieren
Paste = Einfügen
Select = Auswählen
Delete = Löschen
Clear All = Alles Löschen
Move = Bewegen
Drag = Nehmen
Bring to Front = Nach vorne bringen
Send to Back = Nach hinten senden
Align = Ausrichten
Align Left = Links ausrichten
Align Right = Rechts ausrichten
Align Top = Oben ausrichten
Align Bottom = Unten ausrichten
Align Horizontal Centers = Horizontal mittig ausrichten
Align Vertical Centers = Vertikal mittig ausrichten
Distribute Horizontally = Horizontal verteilen
Distribute Vertically = Vertikal verteilen
Distribute Left Edges Equidistantly = Linke Kanten gleich weit verteilen
Distribute Top Edges Equidistantly = Obere Kanten gleich weit verteilen
Align Grid = Gittter ausrichten
Rotate = Drehen
Rotate Left = Links drehen
Rotate Right = Rechts drehen
Flip Horizontal = Horizontal spiegeln
Flip Vertical = Vertikal spiegeln
Rotate and Flip = Drehen und spiegeln
Group/Ungroup Symbol... = Gruppieren/Ungruppieren Schaltsymbol

[menu_project]
View = Ansichten
[/menu_project]
Find = Finden
Zoom In = Vergrößern
Zoom Out = Verkleinern
Fit in Window = In Fenster einpassen
Refresh = Auffrischen
Snap = Fangen
Cross Cursor = Fadenkreuz
Toolbars = Werkzeugleiste
Drawing Tools = Zeichenwerkzeuge
Wiring Tools = Verdrahtungswerkzeuge
Power Objects = Netzobjekte
PCB Tools = Leiterplatten Werkzeuge
Footprint Tools = Bauteil Grundflächen Werkzeuge
Layers Tool = Lagenwerkzeug
Layer Manager = Lagenmanager
Enable and Show All Layers = Aktiviere und zeige alle Lagen
Net Visible = Netz anzeigen
Auto = Automatisch
Digital Objects = Digitale Objekte
Tools = Werkzeuge
Arc Center = Bogen Mitte
Arc Type = Bogentyp
Center Point Arc = Mittelpunkt Bogen
Two-point Arc = Zwei-Punkte Bogen

Place = Plazieren
Drawing Tools = Zeichen Werkzeuge
Arc = Bogen
Elliptical Arc = Elliptischer Bogen
Ellipse = Ellipse
Circle = Kreis
Pie = Kuchen
Line = Linie
Polyline = Polylinie
Rectangle = Rechteck
Rectangular = Rechteckig
The rectangle does not support non-90 degree rotation. Please use Solid Region instead. = Das Rechteck unterstützt keine 90° Drehung. Bitte verwenden Sie stattdessen einen festen Bereich.

Rect = Rechteck Funktion
Round Rectangle = Rechteck abgerundet
Polygon = Vieleck
Bezier = Bezierkurve
Path = Pfad
Graphic = Grafik
Bus = Datenbus
Bus Entry = Datenbus Einspeisung
Junction = Verbindungsstelle
Net Port = Netzanschluss
Voltage Probe = Spannungsmesser
Power Port = Netzanschluss
Wire = Leitung
Annotation = Anmerkung
Track = Leiterbahn
Image = Bild
Arrow Head = Pfeilspitze
Arrowhead = Pfeilspitze
Arrow = Pfeil
No Connect Flag = nicht angeschlossener Bezeichner
Place = Plazieren
Pin = Pin
Lock Selected Objects = Sperre ausgewählte Objekte

Miscellaneous = Verschiedenes
Find Component = Finde Komponente
Component = Komponente
Footprint... = Grundfläche Bauteil...
This component is deleted! = Die Komponente ist bereits gelöscht!
Convert = Konvertieren
Convert Schematic to PCB = Konvertiere Schaltplan in Leiterplatte
The component ID will be reset according to the component prefix, this operation will clear Undo histories. Please notice: = Die Komponenten-ID wird entsprechend der Komponenten Vorsilben zurückgesetzt, dieser Vorgang löscht den Rückgängigkeitsverlauf. Bitte beachten Sie:
Please make sure the component prefixes of the schematic and PCB are corresponding = Bitte stellen Sie sicher, dass die Komponenten Vorsilben des Schaltplans und der Leiterplatte übereinstimmen
Please reset the component ID of corresponding schematic or corresponding PCB too = Bitte setzen Sie auch die Komponenten-ID des entsprechenden Schaltplans oder der entsprechenden Leiterplatte zurück
Do you want to continue? = Möchten Sie fortsetzen?
Reset Component ID = Komopenten ID zurücksetzen?
Component ID reset successfully! = Komopenten ID erfolgreich zurückgesetzen.
Convert to PCB = In Leiterplatte konvertieren
Update PCB = Leiterplatte aktualisieren
Shortcut Keys Setting = Tastaturkürzel einstellen
Edit Symbol... = Schaltsymbol bearbeiten…
Highlight Net... = Netz hervorheben…
Simulate = Simuliere
Simulation = Simulation
Standard Mode = Standardmodus
Simulation Mode = Simulationsmodus
Change to Standard Mode = Wechsel in Standardmodus
Change to Simulation Mode = Wechsel in Simulationsmodus
Welcome to Use LCEDA = Willkommen zu LCEDA
Welcome to Use EasyEDA = Willkommen zu EasyEDA
Enable Education Edition Features for Free >>> = Aktiviere kostenlos die Lerneditionsfunktion >>>
Quick Start = Schnellstart
More Help = Weitere Hilfe
Explore = Erkunden
Message = Nachricht
[start]
Example = Beispiel
Forum = Forum
Tutorials = Anleitungen
Videos = Videos
[/start]
Custom Data = Benutzerdefinierte Daten
LCEDA = LCEDA

Copy Result Image = Kopiere Ergebnisbild
Export Result Image = Exportiere Ergebnisbild
Simulation Result = Simulations Ergebnis
Simulation Results... = Simulations Ergebnisse…
Simulate this Sheet = Simuliere diese Seite
Simulate this Project = Simuliere dieses Projekt
Non-simulation mode, please switch to the simulation mode first and then run = Nicht-Simulationsmodus, bitte erst in den Simulationsmodus wechseln und dann starten
Run the Document = Dokument ausführen
Run the Project... = Projekt ausführen…
Netlist for Document = Netzliste für das Dokument
Netlist for Project = Netzliste für das Projekt
LTspice for This Sheet... = LTspice für diese Seite
Spice for this Project... = Spice für dieses Projekt
Protel/Altium for PCB... = Protel/Altium für Leiterplatte…
PADS for PCB... = PADS für Leiterplatte...
FreePCB for PCB... = FreePCB für Leiterplatte…
Eagle for PCB... = Eagle für Leiterplatte…
Kicad for PCB... = Kicad für Leiterplatte…
OrCAD for PCB... = OrCAD für Leiterplatte…
BOM report... = BOM Bericht…
BOM for Document... = BOM für das Dokument…
BOM for Project... = BOM für das Projekt…
Pin Manager... = Pin-Manager...
Spice Model... = Spice-Model
Layer Manager... = Lagenmanager
Net Color... = Netzfarbe
Design Rule... = Entwurfsregel
Copper Area = Kupferfläche
Rebuild Selected = Auswahl neu aufbauen
Rebuild All = Alles neu aufbauen
Copper Area Manager... = Kupferflächen Manager
Export Pick and Place File = Exportiere Auswahl und Datei ablegen
Measure Distance = Messe Distanz
Set Canvas Origin by Mouse Location = Oberfläche anhand der Mausposition ausrichten
Generates Pick and Place File = Erzeuge Auswahl und Datei ablegen
Unroute All = alle Routen entfernen
Auto Route = Automatisch Routen
Export Autorouter File(DSN) = Exportiere Autorouter Datei (DSN)
Import Autorouter Session File(SES) = Importiere Autorouter Datei (SES)
Autorouter File(DSN) = Autorouter Datei (DSN)
Autorouter Session File(SES) = Autorouter Sitzungsdatei (SES)
Terminate Routing Automatically = Entferne Routing automatisch
Delete Segments = Lösche Segmente
Unroute Connections = Entferne geroute Verbindungen
Unroute Connection = Entferne geroute Verbindung
Unroute Nets = Entferne geroutete Netze
Select = Auswählen
Segments = Segmente
Connection = Verbindung
Net = Netz
Apply Design Rule While Routing and Auto Placing Via = Anwenden der Entwurfsregel während dem Routen und der automatischen Platzierung von Durchkontaktierung

Add SubPart = (Unter)Teil hinzufügen
Annotate... = Kommentieren…
Config = Konfigurieren

Help = Hilfe
About = Über
Shortcut Keys = Tastenkombinationen
FAQ = FAQ
Tutorials = Anleitungen
Basic Tutorials = Basis Anleitungen
Video Tutorials = Video Anleitungen
Essential Check = Grundlegender Check
Simulation Tutorials = Simulations Anleitungen
Updated Instructions = aktualisierte Anleitung
Open File Format = Offenes-Datei-Format
About Upgrade = Über Aktualisierung
User Forum = Benutzer Forum
Feature Request = Besondere Anfrage
Feature Requests = Besondere Anfragen
Bug Report = Fehlerbericht
Bug Reports = Fehlerberichte
Tips & Skill = Tipps & Fähigkeiten
Ask for Help = Um Hilfe fragen
Schematic Capture = Schaltplanaufzeichnung
Spice Simulation = Spice-Simulation
Non-simulation mode = Nicht-Simulationsmodus
PCB Layout = Leiterplatten Layout
General Discussion = Allgemeine Diskussion
More Information = Mehr Informationen
Privacy Policy = Datenschutzbestimmungen
#Terms of Use & Privacy Policy
Terms of Service = Nutzungsbedingungen
Plans and Pricing = Pläne und Preise
Help Translate = Unterstütze bei der Übersetzung
About Us = Über Uns
Contact Us = Kontaktiere Uns
Change History = Änderungshistorie
Join Us = Trete uns bei
#PCB Fabrication Capabilities
PCB Fabrication = Leiterplatten Herstellung
Order Capabilities = Bestellfunktionen
Order Price = Bestellpreise
Order Essential Check = Wesentlicher Bestellcheck
Order FAQ = Bestell-FAQ
Order Process = Bestellprozess
Full Screen = Vollbildschirm

Support = Unterstützung
[leftNavTabs]
Support = Unterstützung
[/leftNavTabs]
Historical Records... = Historie Aufnahme…
Extensions = Erweiterungen
Order PCB... = Bestelle Leiterplatte…
Import Changes = Importiere Änderungen
Press {0}F11{1} to switch to full screen. = Drücke {0}F11{1} zum Wechseln in den Vollbildschirmmodus.
Delete Selected = Lösche Ausgewähltes
Simulate... = Simulieren…
Config = Konfigurieren
Terms of Service & Privacy Policy = Nutzungsbedingungen & Datenschutzbestimmungen
Help Topics = Hilfethemen
3D Model(obj) = 3D-Modell (obj)
3D Model(step) = 3D-Modell (step)
SVG Source... = SVG Quelle
File Source = Quelldatei
Group These Items as a Symbol = Gruppiere diese Einzelteile als Schaltsymbol
Group These Items as a Footprint = Gruppiere diese Einzelteile als Bauteilgrundfläche
Set Canvas Origin = Zeichnungs-Ursprung festlegen
Document Setting = Dokumenteneinstellung
Sheet Properties = Blatteigenschaften
Set Board Outline = Umriss Leiterplatte setzen
Teardrop... = Kegelförmige Vergrößerung
Panelize... = Leiterplatte mehrfach Erstellen
Check Dimension = Prüfe Abmessung
Smart Dimension = Intelligente Abmessung
Footprint Wizard = Bauteil Grundflächen Helfer
Footprint Wizard... = Bauteil Grundflächen Helfer...
Select package type = Pakettyp auswählen
Smart Dimension Properties = Intelligente Abmessungsattribute
Global Delete = Globales Löschen
Cross Probe = Kreuzreferenz
Cross Probe and Place = Kreuzreferenz und platzieren
Paper Size = Papierformat
Register = Registrieren
User Center = Benutzerzentrum

By Mouse Location = Nach Mausposition
Set Coordinate = Setze Koordinate
By Coordinates... = Nach Koordinaten
By Center of Pads = Nach Mitte der Pads
By Center Grid of Symbols = Nach Mitte der Schaltsymbole

#Schematic Canvas Properties
Properties = Eigenschaften
Apply = Anwenden
Save as default = Als Voreinstellung speichern
Canvas Properties = Zeichenblatt Merkmale
Width = Breite
Height = Höhe
Background = Hintergrund
Visible Grid = Sichtbares Gitter
Grid Visible = Gitter Sichtbar
Real-Time Track Length = Echtzeit Leiterbahn Länge
Display Real-Time Track Length = Anzeige Echtzeit Leiterbahn Länge
Grid Color = Gitter Farbe
Grid Size = Gitter Größe
Grid Style = Gitter Stil
Grid.Line Width = Gitter.Linie Dicke
Grid.Line Spacing = Gitter.Linie Abstand
Copper to Board Outline = Kupfer zu Bordumriss
Improve Fabrication = Herstellung verbessern
Spoke Width = Speichenbreite
Stroke Color = Strichfarbe
Stroke Width = Strichdicke
Stroke Style = Strichstil
Fill Color = Füllbarbe
Selected Objects = Ausgewählte Objekte
Frame Size = Rahmengröße
Alt Snap = Alt Fangen
Snap size when pressing the Alt key = Fanggröße beim drücken der ALT Taste
Prefix Start = Vorsilben Start

#Text Properties
Text Properties = Texteigenschaften
Text = Text
Color = Farbe
Font Family = Schriftfamilie
Font Size = Schriftgröße
Font Weight = Schriftstärke
Font Style = Schriftstil
Text Type = Textarten
Text Anchor = Textanker
Baseline = Basislinie
(Auto) = Automatisch
(auto) = automatisch
start = start
middle = Mitte
end = Ende
inherit = Vererben
comment = Kommentar
spice = Spice
normal = Normal
italic = Kursiv
Default = Standard
Add = Hinzufügen
bold = Fett
bolder = Fetter
lighter = Dünner
Failed to parse the font file: {name} = Fehler beim Prüfen der Schriftartdatei: {name}
Please select a font file of ttf or woff format. = Bitte wählen Sie eine Schriftartdatei im ttf oder woff Format.
Add font success: {name} = Erfolgreiche Schriftarten hinzufügen: {name}
Failed to add font: {name} = Schriftart konnte nicht hinzugefügt werden: {name}
Add Font = Schriftart hinzufügen
Failed to parse cached font: {name} = Fehler beim Prüfen der zwischengespeicherten Schriftart: {name}
Load cached fonts fail! = Das Laden der zwischengespeicherter Schriftarten ist fehlgeschlagen!

#Stroke
Stroke Color = Strichfarbe
Stroke Width = Strichdicke
Stroke Style = Strichstil
Fill Color = Füllbarbe
X Radius = X Radius
Y Radius = Y Radius

#spice
Switch mode = Modus umschalten
The current documents will be closed, and reopen after switching mode, do you want to continue? = Die aktuellen Dokumente werden geschlossen und nach dem Wechsel des Modus wieder geöffnet. Möchten Sie fortfahren?
PCB related documents are not allowed in emulation mode = Leiterplatten bezogene Dokumente sind im Emulationsmodus nicht zulässig
Please change the editor to "Simulation" mode first at the top left corner. = Bitte schalten Sie den Editor zuerst oben links in den Modus "Simulation".
Please change the editor to "Standard" mode first at the top left corner. = Bitte schalten Sie den Editor zuerst oben links in den Modus "Standard".
Common = Gemeinsam
spice.open = spice.offen
spice.close = spice.geschlossen
Sources = Quellen
Instruments/Meters = Instrumente/Meter
Transistors = Transistoren
Digital Circuits = Digitale Schaltung
Operational Amplifier = Operationsverstärker
multimeter =
multimeter Settings = Multimeter Einstellungen
FunctionGenerator Settings = Funktionsgenerator Einstellungen
Voltage Source Settings = Spannungsquelle Einstellungen
Current Source Settings = Stromquelle Einstellungen
Powersw Settings = Netzschalter Einstellungen
Resistor Settings = Widerstand Einstellungen
Capacitor Settings = Kondensator Einstellungen
Diode Settings = Diode Einstellungen
voltPowersw Settings = Spannungsnetzschalter Einstellungen
Inductor Settings = Induktivität Einstellungen
VCVS Settings = VCVS Einstellungen
CCCS Settings = CCCS Einstellungen
VCCS Settings = VCCS Einstellungen
CCVS Settings = CCVS Einstellungen
JFET Settings = JFET Einstellungen
FET Settings = FET Einstellungen
Transmission Line Settings = Übertragungsleitung Einstellungen
Oscilloscope Settings = Oszilloskop Einstellungen
XFMR Settings = XFMR Einstellungen
LOGIC Settings = Logik Einstellungen
LOGICSTATE Settings = Logikstatus Einstellungen
DIGITALCLOCK Settings = Digitaluhr Einstellungen
Potentiometer Settings = Potentiometer Einstellungen
MUTUAL_INDUCTORS Settings = Gegenseitige Induktivitäten Einstellungen
NE555 Settings = NE555 Einstellungen
THREE_PHASE Settings = Dreiphasen Einstellungen
Logic_Probe Settings = Logiktastkopf Einstellungen
78XX Settings = 78XX Einstellungen
79XX Settings = 79XX Einstellungen
OPAMP5PEE Settings = OPAMP5PEE Einstellungen
OPAMP5PEECN Settings = OPAMP5PEECN Einstellungen
OPAMP3PEE Settings = OPAMP3PEE Einstellungen
OPAMP3PEECN Settings = OPAMP3PEECN Einstellungen
DELAY_FUSE Settings = Verzögerung Sicherung Einstellungen
Ratio = Verhältnis
K[%]
Model = Modell
States = Zustsände
Voltage[V] = Spannung
Voltage gain[V/V] = Spannungsverstärkung
Current gain[A/A] = Stromverstärkung
Transconductance[Mho]
Transresistance[Ω]
Voltage Source Type = Spannungsquelle
Current Source Type = Stromquelle
multimeter type = Multimeter Typ
power type = Netz Typ
Voltmeter Resistance(R)(Ω) = Spannungsmesser Widerstand
Amperometer Resistance(R)(Ω) = Amperemesser Widerstand
mu.V =
mu.A =
Sine Wave = Sinuswelle
Triangular Wave = Dreieckwelle
Rectangular Wave = Rechteckwelle
AC = Wechselstrom
DC = Gleichstrom
SINE = Sinus
PULSE = Pulse
EXP = Exponentiell
SFFM = SFFM
PWL = PWL
B.spice =
DC Value[V]
DC Value[A]
DC offset[V]
DC offset[A]
Amplitude[V]
Amplitude[A]
Freq[Hz]
Theta[1/s]
Tdelay[s]
Phi[deg]
Tperiod[s]
Ton[s]
Tfall[s]
Trise[s]
Von[V]
Von[A]
Vinitial[V]
Vinitial[A]
Vpulsed[V]
Vpulsed[A]
Rise Delay[s]
Rise Tau[s]
Fall Delay[s]
Fall Tau[s]
Carrier Freq[Hz]
Modulation Index = Modulations Index
Signal Freq[Hz]
Time[s]
Value[V]
Value[A]
Waveforms =
Duty cycle[%]
Amplitude[Vp]
Offset[V]
Rise/Fall Time[sec]
Capacitance[F]
sComponent =
Inductance[H]
Gbw =
Slewrate =
Avol =
Rout(Ω) =
Rin(Ω) =
Ibias[A]
Inhi[V]
Inlo[V]
Isc[A]
Outhi[V]
Outlo[V]
Vabsmax[V]
Vmin[V]
Iq[A]
Cin[F]
high = Hoch
low = Tief
Oscilloscope = Oszilloskop
Logic Analyzer = Logiganalyser
Channel_A = Kanal_A
Channel_B = Kanal_B
Channel A = Kanal A
Channel B = Kanal B
Time = Zeit
Reverse = Umkehren
Simulation file exceed = Simulationsdatei überschritten
The simulation file is too large and has been stopped for performance reasons. = Die Simulationsdatei ist zu groß und wurde aus Performancegründen gestoppt.
Timebase = Zeitbasis
Scale: = Skalierung
X pos.(Div): = X pos.(Einheit)
Y pos.(Div): = Y pos.(Einheit)
View meter... = Messgerät anzeigen
The circuit has components without simulation model: = Die Schaltung hat Komponenten ohne Simulationsmodell:
Your simulation interval is too short to simulate, please wait 5 seconds later and try again; if still show this message, may be you simulated over 500 times the maximum simulation times per day. = Ihr Simulationsintervall ist zu kurz zum Simulieren. Bitte warten Sie 5 Sekunden und versuchen Sie es erneut. Wenn diese Meldung immer noch angezeigt wird, haben Sie möglicherweise über das 500 fache der maximalen Simulationszeiten pro Tag simuliert.
Resistor1_US = Widerstand1_US
Resistor1_EU/IEC = Widerstand1_EU/IEC
Resistor1_3D = Widerstand_3D
Capacitor1_US = Kondensator1_US
Capacitor1_EU/IEC = Kondensator_EU/IEC
Capacitor1_3D = Kondensator_3D
Rheostat_US =
Rheostat_EU/IEC =
Rheostat_3D =
Capacitor_Electrolytic_US = Elektolytkondensator_US
Capacitor_Electrolytic_EU/IEC = Elektolytkondensator_EU/IEC
Capacitor_Electrolytic_3D = Elektolytkondensator_3D
Inductor_US = Induktivität_US
Inductor_EU/IEC = Induktivität_EU/IEC
Inductor_3D = Induktivität_3D
Resistor2_US = Widerstand2_US
Resistor2_EU/IEC = Widerstand2_EU/IEC
Resistor2_3D = Widerstand2_3D
Multimeter = Messgerät
Multimeter_3D = Messgerät_3D
Oscilloscope = Oszilloskop
Oscilloscope_3D = Oszilloskop_3D
Signal_Generator = Signal_Generator
Signal Generator_3D = Signal_Generator_3D
Wattmeter = Leistungsmesser
Wattmeter_3D = Leistungsmesser_3D
NSSWS1080T_3D =
Voltage_Source_VDC = Spannungsquelle_VDC
Voltage_Source_VSin = Spannungsquelle_VSin
Voltage_Source_VPULSE = Spannungsquelle_VPULSE
Voltage_Source_VEXP = Spannungsquelle_VEXP
Voltage_Source_VSFFM = Spannungsquelle_VSFFM
Voltage_Source_VPWL = Spannungsquelle_VPWL
Voltage_Source_V_Behavioral_Source = Spannungsquelle_V_Verhältnis
Current_Source_IDC = Stromquelle_IDC
Current_Source_ISin = Stromquelle_ISin
Current_Source_IPULSE = Stromquelle_IPULSE
Current_Source_IEXP = Stromquelle_IEXP
Current_Source_ISFFM = Stromquelle_ISFFM
Current_Source_IPWL = Stromquelle_IPWL
Current_Source_I_Behavioral_Source = Stromquelle_I_Verhältnis
CCCS_1 =
CCCS_2 =
CCVS_1 =
CCVS_2 =
VCCS =
VCVS =
Three_Phase_Wye_Load = Dreiphasen_Wye_Belastung
Three_Phase_Delta_Load = Dreiphasen_Delta_Belastung
78XX =
79XX =
555 =
555_3D =
Transformer_US = Transformator_US
Transformer_EU/IEC = Transformator_EU/IEC
Transformer_Center_Tapped_US = Transformator_Mittelanschluß_US
Transformer_Center_Tapped_EU/IEC = Transformator_Mittelanschluß_EU/IEC
Mutual_Inductor_US = Gegenseitige Transformator_US
Mutual_Inductor_EU/IEC = Gegenseitige Transformator_EU/IEC
Mutual_Inductor2_US = Gegenseitige Transformator2_S
Mutual_Inductor2_EU/IEC = Gegenseitige Transformator2_EU/IEC
OR2EE_US =
OR3EE_US =
OR4EE_US =
OR2EE_CN =
OR3EE_CN =
OR4EE_CN =
NOR2EE_US =
NOR3EE_US =
NOR4EE_US =
NOR2EE_CN =
NOR3EE_CN =
NOR4EE_CN =
AND2EE_US =
AND3EE_US =
AND4EE_US =
AND2EE_CN =
AND3EE_CN =
AND4EE_CN =
NAND2EE_US =
NAND3EE_US =
NAND4EE_US =
NAND2EE_CN =
NAND3EE_CN =
NAND4EE_CN =
XOR2EE_US =
XOR2EE_CN =
XNOR2EE_US =
XNOR2EE_CN =
Digital_Clock_1Hz = Digitaluhr_1Hz
Logicstate_0 = Logikstatus_0
Logicstate_1 = Logikstatus_1
Logic_Probe = Logiktastkopf
Buffee = Puffer
INVEE_US =
INVEE_CN =
Schmittbuffee = Schmittpuffer
LM358N_US =
LM358N_CN =
OPAMP3PEE_US =
OPAMP3PEE_CN =
OPAMP5PEE_US =
OPAMP5PEE_CN =
Voltage_Controlled_Switch = Spannungsabhängiger_Schalter
Current_Controlled_Switch = Stromabhängiger_Schalter
FUSE = Sicherung
Delay_Fuse = Verzögerung_Sicherung
Transmission_Line = Übertragungsleitung
Crystal = Kristall
DFFEE =
TFFEE =
JKFFEE =
SRFFEE =
SRLATCHEE =
SRNANDFFEE =
SRNORFFEE =
INVTSEE =
INVODEE =
Schmittbuffee = Schmittpuffer
Cbuffer =
SPDT_Open =
SPDT_Close =
SPST_Close =
SPST_Open =
Fast_Crystal = Schneller_Kristall
Lamp = Lampe
BCD_Segment =
Seven_Segment = Siebener_Segment
Traffic_Light = Ampel
Lamp Settings = Lampeneinstellungen
Power[W] = Leistung
Dropout Voltage[V] = Ausstiegsspannung
Current[A]
Threshold[V]
Clock Rate = Taktfrequenz
TrafficLight Settings = Ampellicht Einstellungen
BCDSegment Settings = BCDSegment Einstellungen
SevenSegment Settings = Siebener_Segment Einstellungen
SPDT Settings = SPDT Einstellungen
SPST Settings = SPST Einstellungen
LogicAnalyzer Settings = Logiganalyser Einstellungen
Fuse Settings = Sicherung Einstellungen
Wattmeter Settings = Leistungsmesser Einstellungen
open = offen
close = geschlossen
Common Anode = Gemeinsame Anode
Common Cathode = Gemeinsame Kathode
AC Amplitude = Wechselstrom Amplitude
AC Phase = Wechselstrom Phase
There are some parts haven't spice model, please use "EElib" and "Spice Symbol" at "Libraries" of "Simulation" mode, or you can assign the spice model for them: = Es gibt einige Teile, die kein Spice Model haben, verwenden Sie bitte "EElib" und "Spice Schaltsymbol" unter "Bibliotheken" des "Simulations" Modus, oder weisen Sie ihnen das Spice Modell zu:

#Pin
Pin Properties = Pin Eigenschaften
Orientation = Orientierung
Line 45° = Linie 45°
Line 90° = Linie 90°
Arc 45° = Bogen 45°
Arc 90° = Bogen 90°
Free Angle = Freiwinkel
Start X = Start (X)
Start Y = Start (Y)
Length = Länge
Name = Name
name = name
Number = Nummer
Spice Pin Order = Spice Pin Reihenfolge
Display Number = Nummer anzeigen
Clock = Uhr
Show = Show
Electric = Elektrisch

#Junction
Junction Properties = Verbindungsstelle Eigenschaften
X Location = X-Standort
Y Location = Y-Standort
Size = Größe
Color = Farbe

#Net Label
Net Label = Netzbeschriftung

#Part
Prefix = Vorsilbe

#Image Properties and Dialog
Add Image = Bild hinzufügen
Image Properties = Bildeigenschaften
Image URL = Bild-URL
Input an image URL = Bild-URL angeben
Invalid image URL = Ungültige Bild-URL
Invalid Prefix = Ungültiges Präfix
Failed to load the image = Konnte Bild nicht laden
Image URL contains special characters = Bild-URL beinhaltet Sonderzeichen
From Web URL = Von Web (URL)
From Local Computer = Von lokalem Computer
Please select a png/gif/jpg file. = Bitte Bilddatei auswählen (PNG/GIF/JPG)
Please select an image file. = Bitte Bilddatei auswählen.
Select an image file = Bilddatei auswählen
Insert Image to PCB = Bild in Leiterplatte einfügen
Tolerance = Toleranz
tolerance = toleranz
capacitance = kapazität
frequency = frequenz
Rated Voltage = Nennspannung
Rated Current = Nennstrom
resistance = widerstand
Resistance = Widerstand
Resistance[Ω]
inductance = Induktivität
Operating Temperature = Betriebstemperatur
Shape Invert = Form umkehren
Image Size = Bildgrösse
Color Tolerance = Toleranzfarbe
Simplify Level = Ebene vereinfachen
Corner Threshold = Eck-Schwellwert

#PCB Canvas Properties
Units = Einheiten
Snap Size = Einrastgröße
Other = Andere
Routing Width = Routing-Breite
[router]
Routing Width = Routing-Breite
[/router]
Please using hotkey {0}{key1}{1} or {2}{key2}{3} to change track width while on routing. = Bitte Hotkeys {0}{key1}{1} oder {2}{key2}{3} betätigen, um die Leiterbahnbreite während dem Routing zu modifizieren.
Routing Angle = Verlegewinkel
Routing Conflict = Routing-Konflikt
Remove Loop = Schleife entfernen
Cut SilkScreen = Siebdruck schneiden
Grid = Gitter
Grid 90 = Gitter 90
Grid 45 = Gitter 45
Copper Zone = Kupferzone
Visible = Sichtbar
Invisible = Unsichtbar
Ignore = Ignorieren
Block = Blockieren
RoundTrack = Runde Leiterbahn

#Track
Track Properties = Leiterbahneigenschaften
Layer = Lage
Net = Netz
Start X =
Start Y =
End X =
End Y =
ID = ID

#Pad Properties
Pad Properties = Pad Eigenschaften
Shape = Form
Hole(D) = Lochdurchmesser
Center X = Mitte X
Center Y = Mitte Y
Round = Rund
Oval =
Hole Shape = Lochform
Slot =
Hole(Length) = Lochlänge
Plated = Überzogen
None = Kein
Paste Mask Expansion = Maskenerweiterung einfügen
Solder Mask Expansion = Lötmaskenerweiterung

#Via Properties
Via Properties = Durchkontaktierung Eigenschaften
Diameter = Durchmesser
Drill Diameter = Bohrdurchmesser

#Hole Properties
Hole Properties = Locheigenschaften


#TEXT
Text Properties = Texteigenschaften
Line Width = Liniendicke
Rotation = Drehung
Fonts Management = Schriften Verwaltung

#Dimension Properties
Dimension Properties = Abmessung Eigenschaften

#Footprint Properties
Component Properties = Bauteil Komponenten Eigenschaften
Display Prefix = Anzeige Vorsilbe
Pin Name = Pin Name
Pin Number = Pin Nummer
Spice Pin Number = Spice Pin Nummer
Graphics = Grafik
Pattern = Muster

#Arc Properties
Arc Properties = Bogen Eigenschaften
Start Angle = Anfangswingel
End Angle = Endwinkel
Rotation Direction = Rotierungsrichtung

#Rect Properties
Rect Properties = Rechteck Eigenschaften
Round radius = Runder Radius

#Circle Properties
Circle Properties = Kreis Eigenschaften
Radius = Radius

#CopperArea Properties
CopperArea Properties = Kupferbereich Eigenschaften
Clearance = Zwischenraum
Pad Connection = Pad Verbindungen
Direct = Direkt
Spoke = Speichenförmig
Keep Island = Einzelne Bereiche
Fill Style = Füllstil
CopperArea conflict: copper area outlines in same layer with different net names must not overlap = Kupferbereichs Konflikt: Kupfer Konturen in der gleichen Lage mit unterschiedlichen Netznamen dürfen nicht überlappen.
Copper area rebuild complete! You can set "Copper Zone" as "Visible" at the right-hand property panel after single click the empty area. = Wiederaufbau des Kupferbereichs abgeschlossen! Sie können "Kupferzone" im rechten Eigenschaftsfenster als "sichtbar" einstellen, nachdem Sie den leeren Bereich einmal angeklickt haben.
Please create board outline first. = Bitte erstellen Sie zuerst den Platinen Umriss.
Board outlines are not closed. = Platinenumriss ist nicht geschlossen.
Rebuild CopperArea = Kupferbereich neu aufbauen
Edit Points = Punkte bearbeiten
Direct = Direkt
Spoke = Speichenförmig
No Solid = Nicht Vollflächig
Board Cutout = Platinenausschnitt
Solid = Vollflächig
[copperArea]
None = Keine
[/copperArea]

#Custom Properties
Custom Properties = Benutzerdefinierte Eigenschaften
Fixed Properties = Fixierte Eigenschaften
Add new parameter = Neuen Parameter hinzufügen
Add New Parameter = Neuen Parameter hinzufügen
Add New Supplier = Neuen Lieferant hinzufügen
Mounted = Montiert
Unknown = Unbekannt

Custom = Benutzerdefiniert
Scan the QR code below and open it on the mobile side = Scannen Sie den untenstehenden QR-Code und öffnen Sie ihn auf der mobilen Seite
How to create a single layer PCB = So erstellen Sie eine einlagige Leiterplatte
Currently doesn't support layout single layer directly, please refer at: = Unterstützt derzeit das Layout einer einzelnen Ebene nicht direkt, bitte beachten Sie:

#Dialog Register
Create an account = Konto einrichten
Username = Benutzername
Password = Kennwort
Confirm Password = Kennwort bestätigen
Email = E-Mail
Please read this before you register = Bitte vorher lesen, bevor Sie sich anmelden
Hi {username} = Hallo {username}

#Dialog lostPassword
Lost Password... = Kennwort verloren
Find the password using your email = Kennwort anhand Ihrer E-Mail wiederherstellen



#Dialog Login
Login = Login
Username or Email = Benutzername oder E-Mail
Remember Me = Anmeldedaten merken
Third party = Drittpartei
Login and Register = Anmelden und registrieren
Your login information seems expired, please login again. Don't need to close the opening files, you can continue to save them after login. = Ihre aktuelle Sitzung ist abgelaufen, bitte neu anmelden. Geöffnete Dateien bleiben bestehen und können beim nächsten Login gespeichert werden.

#Dialog Reset Password
Reset a password using your email = Kennwort mit E-Mail zurücksetzen
Your registered email = Ihre registrierte E-Mail

#Dialog Reaction
Re-send an activation code to your email = Aktivierungscode erneut an Ihre E-Mail gesendet

#Dialog Invite
Invite friends to register = Freunde zur Anmeldung einladen
Your friend's email = E-Mail Ihres Freundes

#Dialog Add A New Parameter
Add a new parameter = Neuen Parameter hinzufügen
Key = Schlüssel
Value.new_para = Wert.neu_para
In BOM = In BOM
Add into BOM = In BOM aufnehmen
Invalid key = Ungültiger Schlüssel
This field is required. = Diess Feld ist erforderlich

#Dialog Change Your Password
Change your password = Kennwort ändern
Old password = Altes Kennwort
New Password = Neues Kennwort
Confirm Password = Kennwort bestätigen

#Dialog Create New Design
Save as a New Project = Als neues Projekt speichern
Save as a schematic = Als Schaltplan speichern
Save as Symbol = Als Schaltsymbol speichern
Save as a spice Symbol = Als Spice Schaltsymbol speichern
Save as a spice subckt = Als Spice (Unter)Schaltsymbol speichern
YOU MUST CREATE A SPICE SYMBOL WITH EXACTLY THE SAME NAME AS THIS SUBCKT = Sie müssen ein Spice Schaltsymbol mit exakt dem gleichen Namen erzeugen wie das (Unter)Schaltsymbol.
Save as a PCB file = Als PCB Datei speichern
Save as Footprint = Als Bauteilgrundfläche speichern
Save as a Schematic Module = Als Schaltplanmodul speichern
Save as a PCB Module = Als Leiterplatten-Modul speichern
Save as 3D Model = Als 3D-Modell speichern
Save as a WaveForm = Als Wellenform speichern
Title = Titel
Share = Teilen
Add file = Datei hinzufügen
Visibility = Sichtbarkeit
Allow Comments = Kommentare erlauben
Public (Anyone can see this project but only you can modify it.) = Öffentlich (Nur Sie können das Projekt ändern. Jeder kann es sehen.)
Private (Only you can see and modify this project) = Privat (Nur Sie können das Projekt ändern und sehen.)
Create new project success! = Neues Projekt erfolgreich erstellt!
You can now create files under this project = Unter diesem Projekt können nun Dateien erstellt werden.
This file must be saved under a project, choose other project or create a new project = Diese Datei muss unter einem Projekt gespeichert werden. Bitte in existierendes auswählen oder ein Neues erstellen.
Please login to save this kind of document = Bitte anmelden um dieses Dokument zu speichern
Duplicated project title = Doppelter Projekttitel
#Duplicated document title
Project does not exist = Projekt existiert nicht
Document does not exist = Dokument existiert nicht
document not exists = dokument existiert nicht

Categories = Kategorien
Project = Projekt
Short description = Kurzbeschreibung
Content = Inhalt
Modify this project info. = Diese Projektinfo ändern.
Modify this file info. = Diese Dateiinfo ändern.
Notice = Notiz
Search for it before creating a new one. = Finden Sie es zuerst bevor Sie es neu Erzeugen.
Manufacturer Part Number = Herstellernummer
Supplier = Lieferant
Or = Oder
Supplier Part = Teil vom Lieferant
Supplier Part Number = Lieferantenummer
Link = Link
link = link
The professional function please refer at: = Die professionelle Funktion entnehmen Sie bitte unter:

#Dialog Clone My Part
#Clone it to a project
#Clone it, then edit it
Clone your file = Klonen Sie Ihre Datei

#Dialog Subckt
Attach a Subckt to this spice symbol = (Unter)Schaltsymbol zu diesem Spice Schaltsymbol einarbeiten.
Subckt string = Unterserie
Spice symbol title just allow [0-9][a-z][A-Z] and _ = Spice Schaltsymbole Titel erlauben nur [0-9][a-z][A-Z] und _ als Zeichen

#Design Manager
Design Manager = Design Manager
Nets = Netze
DRC Errors = Designregelprüfung-Fehler
Are you sure you want to unroute this net? = Dieses Netz wirklich unrouten?
Unroute = Unrouten
Track Length = Spurlänge
Via/Hole Outer Size = Äussere Grösse Via/Loch
Filter nets = Nach Netze filtern
Design Rule Checking = Designregelprüfung
Board Outline = Platinenumriss
Plane Zone = Zone Ebene
[drcRule]
Width = Breite
DRC Width = DRC-Breite
Length = Länge
DRC Length = DRC-Länge
Drill Diameter = Bohrdurchmesser
DRC Drill Diameter = DRC-Bohrdurchmesser
Diameter = Durchmesser
DRC Diameter = DRC-Durchmeser
Object = Objekt
DRC Clearance = DRC-Abstand
[/drcRule]
#It will take a while to unroute this net, do you want to continue?
More than one netlabel is found in wire, please checked whether this is correct, if you design it on purpose, please ignore this warning. = Es wurde mehr als ein Netzname in der Verdrahtung gefunden, bitte überprüfen Sie, ob dies korrekt ist, wenn Sie es absichtlich entworfen haben, ignorieren Sie diese Warnung.
Incomplete net, a complete net should contain two or more pins, if you design it on purpose, please ignore this warning. = Unvollständiges Netz, ein vollständiges Netz sollte zwei oder mehr Pins enthalten, wenn Sie es absichtlich entworfen haben, ignorieren Sie bitte diese Warnung.
This netlabel is not connected with any pin. = Dieser Netzname ist mit keinem Pin verbunden.
Incomplete connection, please check. = Unvollständige Verbindung, bitte überprüfen.
The clearance between two objects is less than the Design Rule Checking (DRC) clearance which has different nets. = Der Abstand zwischen zwei Objekten ist kleiner als der in der Designregelprüfung (DRC) angegebene Abstand, der unterschiedliche Netze.
The diameter is less than Design Rule Checking (DRC) diameter = Der Durchmesser ist kleiner als der in der Designregelprüfung (DRC) angegebene Durchmesser
The drill diameter is less than Design Rule Checking (DRC) drill diameter = Der Bohrdurchmesser ist kleiner als der in der Designregelprüfung (DRC) angegebene Bohrdurchmesser
The track length is longer than Design Rule Checking (DRC) track length = Die Leiterbahnlänge ist länger als die in der Designregelprüfung (DRC) angegebene Leiterbahnlänge
The track width is less than Design Rule Checking (DRC) track width = Die Leiterbahnbreite ist kleiner als die in der Designregelprüfung (DRC) angegebene Leiterbahnbreite

#Dialog Simulation
Show your simulation report = Ihren Schaltplan Simulationsreport zeigen
Download netlist = Netzliste herunterladen
Run = Starten
Components = Komponenten

#Dialog Import
Import file from your computer = Datei von Ihrem Computer importieren
Maximum file size: 30 MB = Maximale Dateigrösse: 30MB
Maximum file size: 100 MB = Maximale Dateigrösse: 100MB
Chose file = Datei schlissen
File Operation = Dateioperation
Import File = Datei importieren
Extract Libs = Bibliotheken entpacken
Import File and Extract Libs = Datei importieren und Bibliotheken exportieren
File type = Dateityp
The file size is too large. = Dateigrösse zu gross.
Please selected the file type. = Bitte Dateityp auswählen.
No component was found! = Keine Komponenten gefunden!
Import successfully = Import erfolgreich
Import failed = Import fehlgeschlagen
Click OK to continue with the import = "OK" betätigen um mit Importvorgang fortzufahren
Select None = Nichts auswählen

#Dialog Modify Symbol Information
Modify symbol information = Schaltsymbol Informationen ändern
Spice Prefix = Spice-Präfix
Hide Pin = PIN verstecken
Pin Manager = Pin Manager
When a power pin is hidden, it will be marked as netlabel, you don't need to wire it. If you use it as simulation, please show it or create a GND/VCC Net for it. = Wenn ein Netz Pin ausgeblendet ist, wird er als Netzname gekennzeichnet, Sie müssen ihn nicht verdrahten. Wenn Sie es als Simulation verwenden, zeigen Sie es bitte oder erstellen Sie ein GND/VCC-Netz dafür.
Assign = Zuweisen
Supplier.bom = Anbieter.bom
LCSC.bom =
Price = Preis
Quantity.bom = Menge.bom
Package.bom = Paket.bom
Components.bom = Komponenten.bom
Manufacturer Part.bom = Hersteller Teile.bom
Manufacturer.bom = Hersteller.bom

One-click Purchasing at LCSC = Ein Klick Kauf bei LCSC
Order Parts = Teile bestellen/Lagerstand überprüfen
Export BOM = BOM exportieren
Export PCB BOM = BOM der Leiterplatte exportieren
Export Schematic BOM = BOM des Schaltplans exportieren
ID.bom =
Name.bom = Name.bom
[bom]
Name = Name
LCSC Assembly = LCSC-Fertigung
Value = Wert
ID = ID
Supplier = Lieferant
LCSC = LCSC
Price = Preis
Quantity = Quantität
Package = Gehäuse
Components = Komponenten
Manufacturer = Hersteller
[/bom]
Manufacturer Part = Herstellernummer

#Dialog Run
Run your simulation = Starten Sie Ihre Simulation
Transient = Einmalige Simulation
Maximum Timestep = Maximaler Zeitschritt
Stop Time = Stoppzeit
Start Time = Startzeit

AC Analysis = Wechselstrom Analyse
Type of Sweep = Typ des Signalverlaufs
Number of points = Anzahl Punkte
Start Frequency = Startfrequenz
Stop Frequency = Stoppfrequenz

DC sweep = Gleichstrom Signalverlauf
Source to Sweep = Quelle des Signalverlaufs
Start Value = Startwert
Stop Value = Stoppwert
Increment = Zuwachsrate
DC Transfer = Gleichstromübertragung
Output = Ausgang
Source = Quelle

DC op pnt = Gleichstromanalyse mit Quellenwerten durchführen
Compute the DC operating point treating capacitances as opens and inductances as shorts = Berechne den Gleichstrom Betriebspunkt wie mit offenen Kondensatoren und mit kurzgeschlossenen Induktivitäten.

#Dialog Share Info
Active File = Aktive Datei
Active Project = Aktives Projekt
Readonly = Nur Lesen
Editable = Veränderbar
Active file's owner project page = Projektseite des aktuellen Projektinhabers
Active project editor page = Seite des aktuellen Projektbearbeiters

#Dialog Document Recovery
All Projects = Alle Projekte
Document Recovery = Dokument Wiederherstellung
Unsaved files = Ungespeicherte Dateien
Please select a file! = Bitte Datei auswählen!
Please expand the folder first, then select a document to recover. = Bitte Ordner zuerst expandieren und dann ein Dokument zum wierherstellen auswählen.
Are you sure you want to remove this backup? = Dieses Backup wirklich entfernen?

#Dialog Find Libs
Search = Suchen
Search Results = Suchresultate
Search and press Enter = Suchen und Enter drücken
Keywords at least 3 characters = Suchfilter (mind. 3 Zeichen)
Assembled = Montiert
Verified = Verizfiert
In stock = Auf Lager
{page} of {pagecount} pages = Seite {page} von {pagecount}
Common Modules = Allgemeine Module
User Contributions = Beiträge von Benutzern
More = Mehr
Add Favorite = Zu Favoriten hinzufügen
Remove Favorite = Von Favoriten entfernen
Add Sub Part = Unterteil hinzufügen
Untagged = Nicht getagged
Package = Gehäuse
package = gehäuse
Title(PartNO) = Titel (Partnummer)
No Data! = Keine Daten!
Quantity = Menge
Manufacturer Part = Herstellernummer
manufacturer Part = herstellernummer
Manufacturer = Hersteller
manufacturer = hersteller
voltage = spannung
Library = Bibliothek
LCSC Assembled = Durch LCSC montiert
JLCPCB Assembled = Durch JLCPCB montiert
User Contributed = Von Benutzer angefertigt
Symbol = Symbol
Follow = Folgen
Types = Typen
Classes = Klassen
power = leistung
Power = Leistung
LCSC Part# = LCSC Teil#
Stock = Lager
Report Error... = Fehler melden...
Report Error = Fehler melden
Thanks for your feedback! = Danke für Ihr Feedback!
Report error success, thanks for your report! = Fehler erfolgreich gemeldet. Danke für Ihr Feedback!
The content must be at least 2 characters! = Der Inhalt muss mindestens 2 Zeichen beinhalten.
This library is user contributed, please check before using. = Achtung: Bibliothek durch Drittpartei erstellt. Angaben ohne Gewähr.
[lib]
All = Alle
System = System
Personal = Persönlich
Created = Erstellt
Favorite = Favorit
No Team found. Please join or create a team first. = Kein Team gefunden, bitte zuerst eines erstellen.
Create a team = Team erstellen
No follow user found. Please follow your friend first. = Sie folgen keinem User.
[/lib]


BUY = KAUFEN
In Stock = An Lager
Out of Stock = Nicht an Lager
Minimum = Minimum
Distributor = Händler

Capacitance = Kapazität
Frequency Tolerance = Frequenztoleranz
Power (Watts) = Leistung (Watt)
Power - Max = Leistung - Max
Frequency = Frequenz
Voltage Rating(Vdc,Vac) = Nennspannung (Vdc, Vac)
Voltage = Spannung
Current Rating = Nennstrom
Rated current = Nennstrom
Resistance (Ohms) = Widerstand (Ohm)
Resistance(Ohms) = Widerstand (Ohm)
Inductance = Induktanz
FET Type = FET-Typ
Current Rating(Max) = Nennstrom (Max)
Impedance @ Frequency = Impedanz bei Frequenz
Voltage - Input (Max) = Eingangspannung (Max)
Voltage - Input (Min) = Eingangspannung (Min)
Voltage - Supply = Betriebsspannung
Voltage - Max = Spannung - Max
Current - Output = Ausgangstrom

#Dialog Export Your Works
Export your works = Exportieren Sie Ihre Arbeit
Export to = Exportieren nach
Zoom = Zoom
Image Type = Bildtyp
Qualify = Qualifizieren
0 means real size = 0 bedeutet original Größe
Merged layer = Vereinigte Lagen
Separated layer = Getrennte Lagen
Paged layer = Ausgelagerte Lage
Layer = Lage
Export = Export
Mirror = Spiegel
TopLayer = Obere Lage
BottomLayer = Untere Lage
TopSilkLayer = Obere Beschriftungs Lage
Protractor Properties = Winkelmesser Eigenschaften
BottomSilkLayer = Untere Beschriftungs Lage

BoardOutLine = Platinenumriss
TopAssembly = Obere Montage Lage
BottomAssembly = Untere Montage Lage
Mechanical = Mechanisch
DocumentLayer = Dokumenten Lage
Inner{number} = Innere {number}
Substrate{number} =
Color = Farbe
Full Color = Vollfarbe
Canvas Setting = Zeichnungseinstellungen
Full Graphics = Vollgrafik
Assembly Drawings = Montagezeichnung
Object Outlines = Objekt Außenlinien
Invalid file format = Falsches Dateiformat
Failed to export file = Dateiexport fehlgeschlagen
Download now = Jetz herunterladen
Wire Width = Drahtdicke
Sheet = Seite
Merged sheet = Zusammengefügte Seite
Separated sheet = Getrennte Seite
Engine =
Exporting PDF = PDF exportieren
Export 3D Model = 3D Model exportieren
[exportDocument]
Size = Größe
[/exportDocument]

#Dialog Import Changes
Confirm Importing changes information = Importierte Änderungen Bestätigen
You can't undo this operation, Please run a Design Rule Checking (DRC) after this operation. = Aktion kann nicht rückgängig gemacht werden. Bitte Designregelprüfung (DRC) nach dieser Operation durchführen.
Apply Changes = Änderungen anwenden
This is a simple Design Rule Checking (DRC). = Dies ist ein simple Designregelprüfung (DRC).
It just can help you to find the obvious errors = Hiermit können offensichtliche Fehler während des Entwurfs gefunden werden.
There are some unfinished nets, do you want to check the nets first? = Einige Netze sind nicht ganz geschlossen, diese zuerst überprüfen?
Yes, Check Nets = Ja, übeprüfen
No, Keep Going = Nein, weitefahren

#Dialog Layer Manager
Configured = Konfigurieren
Layer Name = Lagen Name
TopPasterLayer = Obere SMD-Bereich Lage
BottomPasterLayer = Untere SMD-Bereich Lage
TopSolderLayer = Obere Löt Lage
BottomSolderLayer = Untere Löt Lage
TopPasteMaskLayer = Obere SMD-Bereich Maskierungs Lage
BottomPasteMaskLayer = Untere SMD-Bereich Maskierungs Lage
TopSolderMaskLayer = Obere Lötmaskierungs Lage
BottomSolderMaskLayer = Untere Lötmaskierungs Lage
ComponentShapeLayer = Komponenten Form Lage
LeadShapeLayer = Lötform Lage
ComponentMarkingLayer = Komponenten Makierungs Lage
Ratlines = Leiterbahnen(Unverlegt)
Ratlines Color = Leiterbahnen Farbe(Unverlegt)
Manage Colors = Verwalte Farben
BoardOutline = Platinenumriss
Multi-Layer = Mehrfachlagen
Hole = Bohrung
DRCError = DRCFehler
Setting = Einstellung
Drawing area = Zeichenbereich
Export area = Exportbereich
Transparency(%) = Transparez(%)
Copper Layer = Kuppfer Lage
Signal =
Plane = Ebene
Non-Signal = Nicht-Signal
Other = Andere
Please delete all the objects of the layers first! The layers are: = Bitte löschen Sie zuerst alle Objekte der Lagen! Die Lagen sind:
You are converting Signal Layer to Plane Layer, There're some non-track objects remain on following layers. Please delete the objects manually on the canvas. = Sie konvertieren die Signal Lage in eine Flächen Lage. Es verbleiben einige Nicht Leiterbahn Objekte auf den folgenden Lagen. Bitte löschen Sie die Objekte manuell auf der Zeichenfläche.
Please delete all the objects of this layer first! = Bitte löschen Sie zuerst alle Objekte dieser Lage!

#Dialog Fabrication Output
Create Files = Erzeuge Dateien
Check your {0}Gerber files{1} carefully before sending them to the factory = Überprüfen Sie Ihre {0}Gerber Dateien{1} sorgfältig, bevor Sie sie an das Werk senden
Download free Gerber Viewer (gerbv) = Laden Sie den freien Gerber Viewer (gerbv) herunter
Before generating the Gerber files = Vor dem Generieren der Gerber Dateien
Please check the packages size and orientation carefully. = Bitte überprüfen Sie die Größe und Ausrichtung der Pakete sorgfältig.
Please check for Design Rule Checking (DRC) errors in the Design Manager. = Bitte prüfen Sie im Design Manager auf Fehler bei der Designregelprüfung (DRC).
Please rebuild the copper area after modifying tracks and packages. = Bitte bauen Sie den Kupferbereich neu auf, nachdem Sie Leiterbahnen und Pakete geändert haben.
After generating the Gerber file, please use the {0}Gerber Viewer{1} to check whether it conforms to the design requirements. = Verwenden Sie nach dem Generieren der Gerber-Datei den {0}Gerber Viewer{1}, um zu überprüfen, ob sie den Designanforderungen entspricht.
Order PCB/SMT = Bestelle Leiterplatte/SMT bei JLCPCB
Found the complicated polygon that object cannot be generated at Gerber, please remove or replace = Kompliziertes Polygonobjekt gefunden, das bei Gerber nicht generiert werden kann, bitte entfernen oder ersetzen
ID: {id}, Object: {object}, Location: {location} =

#Dialog DRC
Item = Artikel
Value = Wert
value = wert
Unit = Einheit
Track Width = Leiterbahnbreite
Track to Track = Leiterbahn zu Leiterbahn
Track to Pad = Leiterbahn zu Pad
Pad to Pad = Pad zu Pad
Via to Via = Durchkontaktierung zu Durchkontaktierung
Via Hole Size = Durchgangbohrungs Größe
Realtime DRC = Echtzeit Designregelprüfung (DRC)
{0} is too small! = {0} ist zu klein!
Invalid DRC Rule = Unültige Designregelprüfung(DRC) Regel
Rule = Regel
Via Diameter = Durchkontaktierung Durchmesser
Via Drill Diameter = Durchkontaktierung Bohrdurchmesser
Net List = Netzliste
Rule = Regel
Set Rule = Regel setzen
Check Object to Copper Area = Objekt zu Kupferbereich überprüfen
Show DRC Boundary while Routing = DRC-Grenze während Routing anzeigen
Check Object to Board Outline = Objekt zu Platinenumriss überprüfen
Rule name already exists! = Regelname existiert bereits!
You should not delete default rule! = Standardregeln sollten nicht gelöscht werden!
Rule list contains invalid rule setting! = Regelliste beinhaltet ungültige Konfigurationen!
Duplicate rule name exists! = Duplikat von Regelnamen existiert bereits!
via diameter is smaller than via drill diameter! = Durchkontaktierung Durchmesser ist kleiner als der Lochdurchmesser!
Currently rule name is not allowed to contain magical characters like . and $ = Regelnamen dürfen Sonderzeichen wie . und $ nicht beinhalten.
[drcRule]
All = Alle
[/drcRule]

#Dialog  Update PCB
Update PCB(Synchronizing PCB from schematics) = Leiterplatte aktualisieren (Leiterplatte aus Schaltplänen synchronisieren)


#Dialog Hotkey
Change Canvas Unit = Zeichnungseinheit ändern
Copy Selected Object(s) by Reference Point = Gewählte Objekte bei Referenzpunkt kopieren
Fullscreen = Vollbildschirm
Undo the Previous Draw = Vorige Zeichnung Rückgänig machen
Set Canvas Origin by Coordinate = Zeichnungsursprung bei Koordinate setzen
Switch to the Next Signal Layer = Zur nächste Signallage wechseln
Switch to the Previous Signal Layer = Zur vorherige Signallage wechseln
Switch object to top layer or bottom layer = Objekt zwischen oberen oder unteren Lage wechseln
Cycle Forward to the Next Open Tabbed Document = Zum nächsten geöffnet Dokument im Tab wechseln
Cycle Backward to the Previous Open Tabbed Document = Zum vorherigen geöffnet Dokument im Tab wechseln
Switch to the Previous Layer(on the Numeric Keypad) = Zur vorherigen Lage wechseln (Numerisches Keypad)
Switch to the Next Layer(on the Numeric Keypad) = Zur nächsten Lage wechseln (Numerisches Keypad)
Toggle Layers Which is Not Active = Nicht aktive Lage umschalten
Hotkey Setting = Schnelltasten Einstellung
Document Type = Dokumententyp
Shortcut = Verknüpfung
Function = Funktion
ALL = Alle
SCH = SCH
Rotate Selected Objects = Ausgewählte Objekte rotieren
Scroll or Move Selected Left = Selektierte nach links abrollen/verschieben
Scroll or Move Selected Right = Selektierte nach rechts abrollen/verschieben
Scroll or Move Selected Up = Selektierte nach oben abrollen/verschieben
Scroll or Move Selected Down = Selektierte nach unten abrollen/verschieben
Set canvas origin to the center grid of graphics in symbol; Set canvas origin to the center of pads in footprint. = Stellen Sie den Zeichnungsursprung auf das mittlere Gitter der Grafiken im Schaltsymbol ein; Legen Sie den Zeichnungsursprung auf die Mitte der Pads in der Bauteilgrundfläche fest.
Cross Document Paste = Dokumentenübergreifend einfügen
Explore & Find Components = Komponenten erkunden und suchen
Select All = Alles Auswählen
Cancel Current Drawing = Aktuelle Zeichnung abbrechen
Save = Speichern
Drag Tool = Nehme Werkzeug
Draw Wire = Zeichne Leitung
Draw Bus = Zeichne Datenbus
Bus Entry = Datenbus Einspeisung
Junction = Verbindungsstelle
Net Flag GND = Netzbezeichnung (GND)
Net Flag = Netzbezeichnung
Draw Polyline = Zeichne Polyline
Draw Polygon = Zeichne Vieleck
Draw Bezier = Zeichne Bezierkurve
Draw Arc = Zeichne Bogen
Draw Rect = Zeichne Rechteck
Draw Ellipse = Zeichne Ellipse
Freehand Draw = Freihandzeichnung
Freedraw = Freihand
Draw Text = Zeichne Text
Edit Selected Symbol = Editiere Ausgewähltes Schaltsymbol
Draw Track = Zeichne Leitung
Draw Circle = Zeichne Kreis
Cycle Select Object at Current Location = Am aktuellen Standort ausgewähltes Objekt durchwechseln
Draw Dimension = Zeichne Abmaße
Draw Connect = Zeichne Verbindung
Draw CopperArea = Zeichne Kupferbereich
Change to TopLayer;<br/>Change Selected Component's Layer to TopLayer; = Zur obersten Lage wechseln;<br/>Ausgewählte Komponentelage zur obersten Lage ändern;
Change to BottomLayer;<br/>Change Selected Component's Layer to BottomLayer; = Zur untersten Lage wechseln;<br/>Ausgewählte Komponentelage zur untersten Lage ändern;
Change to Inner1 = Wechsel zu Inner1
Change to Inner2 = Wechsel zu Inner2
Change to Inner3 = Wechsel zu Inner3
Change to Inner4 = Wechsel zu Inner4
Highlight Net = Netz hervorheben
Place Pad = Platziere Pad
Place Via = Platziere Durchkontaktierung
Measure = Messen
Change Routing Angle = Verlegewinkel ändern
Change Routing Conflict = Verlegekonflikt ändern
Decrease Routing Width = Verlegedicke verkleinern
Increase Routing Width = Verlegedicke vergrößern
Decrease Snap Size = Vergrößere Fanggröße
Increase Snap Size = Verkleinere Fanggröße
Change Copper Zone Visible or Invisible = Kupferzone sichtbar oder unsichtbar ändern
Rebuild All Copper Area = Kupferbereiche neu aufbauen
Toggle PCB Net Display = Nettoanzeige Leiterplatte umschalten
Show Property Dialog When Placing Object;<br/>Show Location Setting Dialog When Pasting Object(s) = Attributdialog beim Platzieren von Objekten anzeigen;<br/>Dialogfeld Standorteinstellung beim Einfügen von Objekten anzeigen
Show Property Dialog When Placing Object;<br/>Show Absolute Offset Dialog When Selecting Object(s);<br/>Show Location Setting Dialog When Pasting Object(s) = Attributdialog beim Platzieren von Objekten anzeigen;<br/>Absoluter Versatzdialog beim Auswählen von Objekt(en) anzeigen;<br/>Positionseinstellungsdialog beim Einfügen von Objekten anzeigen
Show Relative Offset Dialog When Selecting Object(s) = Dialogfeld "Relativen Versatz anzeigen" bei der Auswahl von Objekten
Open the FAQ Page = Öffnen Sie die FAQ-Seite
Move Object(s) by Reference Point = Objekt(e) nach Referenzpunkt verschieben
Choose Favorite Track Width While Routing = Wählen Sie die bevorzugte Leiterbahnbreite beim Routing
Copy Selected Object(s) and Paste Repeatedly = Ausgewählte(s) Objekt(e) kopieren und wiederholt einfügen

#My Projects Tree Menu
New Project = Neues Projekt
New Schematic = Neuer Schaltplan
New PCB = Neue Leiterplatte
New Spice Subckt = Neues Spice (Unter)Schaltsymbol
Modify = Ändern
Delete = Löschen
Add sub part = Zum (Unter)Teil hinzufügen
Clone = Klonen
Version History = Versionsverlauf
Refresh List = Liste neu laden
Create New Project = Neues Projekt erstellen
Delete = Löschen
Attachment = Anhang
Archive = Archiv
Transfer = Transfer
Manage Project = Projekt verwalten

#Dialog Verify Package
Footprints Verification = Bauteilgrundflächen Überprüfung

#Dialog Edit Polygon Pad points
Edit Points = Punkte bearbeiten
Center point is outside the pad = Mittelpunkt liegt außerhalb des Pads
Hole should be inside the pad = Loch sollte sich innerhalb des Pads befinden
Hole is draggable = Loch ist ziehbar

#My Part Tree Menu
Clone = Klonen
Reload parts = Teile neuladen
Layers = Lagen

#Dialog Preferences
Language = Sprache
Display Name = Anzeigename
HotKey Sync = HotKey-Synchronisierung
My Theme Sync = Meine Theme-Synchronisierung
Document Recovery Setting = Einstellung für die Dokumentwiederherstellung
Enable auto backup = Automatische Sicherung aktivieren
Maximum backup level = Maximales Backup-Level
Auto backup interval = Intervall der automatischen Sicherung
minutes = Minuten
Save to Server = Auf dem Server speichern
Load from Server = Vom Server Laden


#Dialog Schematic Library Wizard
Symbol Wizard = Symbolassistent
Style = Stil
Picture = Bild
Pin Names = Pin Namen
Contributor = Mitwirkende
contributor = mitwirkende
owner = Inhaber

#Dialog Annotate
Annotate = Kommentieren
Scope = Anwendungsbereich
Active Schematic only = Nur aktiver Schaltplan
All Opened Schematics = Alle geöffneten Schaltpläne
Method = Verfahren
Re-annotate all = Alle Neukommentieren
Keep existing annotation = Existierende Kommentare beibehalten
Direction = Richtung
Rows = Reihen
Cols = Spalten
Reset = Zurücksetzen

#Dialog Order
Order... = Bestellen...
PCB Qty. = Leiterplatte Anzahl
PCB Thickness = Leiterplatte Dicke
PCB Dimension = Leiterplatte Abmaße
Automatic calculation = Automatische Kalkulation
PCB Color = Leiterplatte Farbe
Green = Grün
White = Weiß
Blue = Blau
Red = Rot
Yellow = Gelb
Black = Schwarz
Purple = Violett
Copper = Kupfer
Gold = Gold
Silver = Silber
Surface Finish = Oberflächenbehandlung
Hasl = Hasl
Hasl(Lead Free) = Hasl(Beifrei)
ENIG = ENIG

#Dialog Hot Key config
Restore All Default Shortcuts = Alle Standard Tastaturkürzel wiederherstellen
Save Changes = Änderungen speichern



#Dialog Polyline Maybe Wire
To connect electrical elements, please use Wire (W hotkey) and not Line (L hotkey). = Um elektrische Elemente zu verbinden, benutzen Sie bitte Leitung (W Schnellstaste) und nicht Linie (L Schnelltaste).

Anonymous File = Anonyme Datei
Anonymous File can not be cloned, but you can open it, then save it as a new file. = Anonyme Dateien können nicht geklont werden. Bitte Datei öffnen und manuell als andere Version abspeichern.
Free Documents = Kostenlose Dokumente
You must close the file before delete it! = Sie müssen die Datei schließen, bevor Sie sie löschen!
Offline Project = Offline Projekt

#Message box
Confirmation = Bestätigung
Alert = Alarm
Information = Information
information = information
Prompt = Eingabeaufforderung
Error = Fehler
error = fehler
error! = fehler!
Warning = Warnung
Imported ok! = Importierung ok!
Some changes have not been saved. = Einige Änderungen wurden nicht gespeichert.
Your file hasn't been saved. Please save first! = Datei nicht gespeichert. Bitte zuerst speichern!
Your file hasn't been saved. Are you sure you want to close it? = Ausstehende Änderungen wurden nicht gespeichert. Wirklich schliessen?
Error! Please try again later. = Fehler! Bitte später erneut versuchen.
Are you sure you want to reload this page? = Seite wirklich neu laden?
Are you sure you want to leave this page? = Seite wirklich verlassen?
Confirm Reload = Neu laden bestätigen
Confirm Close = Schliessen bestätigen
Reload this page = Seite neu laden
Leave this page = Seite verlassen
Stay on this page = Auf Seite bleiben
Don't reload = Nicht neu laden
No connect flag only can be placed on Pin dot or the wire which is connected one Pin. = Es kann kein "Nicht Verbunden" Bezeichner nur auf dem Pin oder dem Draht platziert werden, der mit einem Pin verbunden ist.
can not be placed on the wire which is placing No Connect Flag. = kann nicht auf dem Draht platziert werden, der den "Nicht Verbunden" Bezeichner platziert hat.
The footprint transfer to LCSC library class successfully = Die Übertragung der Bauteilgrundfläche in die LCSC-Bibliotheksklasse war erfolgreich
Device/Footprint goes into "SMT Device/Footprint Verified" list successfully = Gerät/Bauteilgrundfläche wird erfolgreich in die Liste "SMT Device/Footprint Verified" aufgenommen

Load failure! = Fehler beim Laden!
Load projects failed = Laden von Projekten fehlgeschlagen
error info = Fehlerinformation
error information = fehlerinformation
Guest can't create a new project. Please login! = Gast kann kein neues Projekt erstellen. Bitte loggen Sie sich ein!
Please create a project before you do this! = Bitte erzeugen Sie ein Projekt bevor Sie dies tun!
Add Part success = Teile hinzufügen erfolgreich
Click the new part and then edit it! = Klicken Sie auf das neue Teil und bearbeiten Sie es dann!
Delete my work = Lösche meine Arbeit
Delete my work. (Only deletes it from this list but not from the server) = Löschen Sie meine Arbeit. (Löscht es nur aus dieser Liste, aber nicht vom Server)
Do you confirm this? = Bestätigen Sie dies?
Successfully deleted! = Erfolgreich gelöscht !
Successfully Copied! = Erfolgreich kopiert!
Cloning success! = Klonen erfolgreich !
Your title is too short! = Ihre Überschrift ist zu kurz!
Remove this part = Entfernen Sie diesen Teil
Find and Jump to ... = Suche und springe zu …
Please type the prefix, such as U1, R1, C1 = Bitte geben Sie Vorsilben ein, wie U1,R1,C1 etc.
Zoom as 1:1, you can print it and then create artwork for etching the PCB. = Vergrößerungsfaktor auf 1:1 stellen, dann können Sie Drucken und die Leiterplatte für den Ätzvorgang erstellen.
Exporting your works! = Exportiere Ihre Arbeiten!
Guests can't import a file. Please login! = Besucher können keine Dateien importieren, bitte einloggen
Please create a project before you import a file! = Bitte erzeugen Sie zuerst ein Projekt bevor Sie eine Datei importieren!
Import your LTspice file! = Importieren Sie Ihre LTspice Datei!
Open LTspice file = LTspice Datei öffnen
Please make sure the selected LTspice file is a file saved in LTspice V and above. = Bitte stellen Sie sicher, dass die ausgewählte LTspice Datei eine in LTspice V und höher gespeicherte Datei ist.
Saved successfully! = Erfolgreich gespeichert!
Save failed! = Speichern fehlgeschlagen!
Can not place parts into this document. = Es können keine Teile in dieses Dokument eingefügt werden.
User Package = Benutzer Pakete
System Package = System Pakete
File error = Dateifehler
Please save your file first! = Bitte speichern Sie Ihre Datei zuerst!
Email address is too short! = E-Mail Adresse ist zu kurz!
You have not selected a file to upload. = Sie haben keine Datei zum Hochladen ausgewählt.
Update = Aktualisieren
No changes, the PCB already matches the schematic! = Keine Änderungen, die Leiterplatte entspricht bereits dem Schaltplan!
Only public files can be shared = Nur Öffentliche Dateien können geteilt werden
Conversion to PCB has failed! = Umwandlung nach Leiterplatte ist fehlgeschlagen!
Your username is too short! = Ihr Benutzername ist zu kurz!
Your password is too short, it must be more than 6 characters! = Ihr Passwort ist zu kurz, es muss mehr als 6 Zeichen lang sein!
Conflicting shortcut = Widersprüchliche Verknüpfung
There is an empty PCB file. Please first run Convert Schematic to PCB... from the schematic = Dies ist eine leere Leiterplatten Datei. Bitte starten Sie zuerst „Projekt zu Leiterplatte umwandeln…“ vom Schaltplan aus
This file has been modified, are you sure you want to run this simulation before saving it first? = Diese Datei wurde geändert, sind Sie sicher das Sie diese Simulation starten möchten? Vielleicht sollten Sie Sie erst speichern?
Please enter the Maximum Timestep! = Bitte geben Sie den maximalen Zeitschritt ein!
Please enter the Stop Time! = Bitte geben Sie die Stop Zeit ein!
All of these fields are needed. = Alle diese Felder werden benötigt.
Either your spice netlist is too big or the server is busy. Please try again later. = Entweder Ihre Spice Netzliste ist zu groß oder der Server ist überlastet. Bitte versuchen Sie später noch einmal.
Your spice netlist is too big! Try breaking your circuit into smaller simulatable blocks. = Ihre Spice Netzliste ist zu groß! Versuchen Sie Ihre Schaltung in kleinere simulierbare Blöcke zu unterteilen.
Too many users in simulation. Please try again later! = Zu viele Benutzer in der Simulation. Bitte versuchen Sie es später noch einmal!
Due to limited server resources, please wait 10 seconds for the interval in every time simulation. = Aufgrund begrenzter Serverressourcen warten Sie bitte bei jeder Zeitsimulation 10 Sekunden auf das Intervall.
Your circuit is too complex, we have not enough CPU resource to support this simulation, please reduce your circuit as small as you can. = Ihre Schaltung ist zu komplex, wir haben nicht genügend CPU-Ressourcen, um diese Simulation zu unterstützen. Bitte reduzieren Sie Ihre Schaltung so klein wie möglich.
Simulation is queuing, try again after 30s. = Simulation ist in der Warteschlange, versuchen Sie es nach 30 Sekunden erneut.
Timeout = Zeitüberschreittung
Demo accounts don't support simulation, please login first = Demokonten unterstützen keine Simulation, bitte melden Sie sich zuerst an
Please login first = Bitte zuerst anmelden
The schematic is showing errors, please check the simulation report carefully! = Der Schaltplan zeigt Fehler, bitte prüfen Sie den Simulationsreport sorgfältig!
Simulation too long, maybe your schematic is too complex. = Simulation ist zu lang, es kann sein das die Schaltung zu komplex ist.
Non-simulated file = Nicht simulierte Datei
This file can only be opened in standard mode. To open it, please switch to standard mode. = Diese Datei kann nur im Standardmodus geöffnet werden. Um es zu öffnen, wechseln Sie bitte in den Standardmodus.
Load your preferences success! = Ihre Einstellungen wurden erfolgreich geladen !
Save your preferences success! = Ihre Einstellungen wurden erfolgreich gespeichert !
Update subckt ok! = Aktualisierung des (Unter)Schaltsymbols ok !
Clone your file = Klonen Sie Ihre Datei
Please type a new file name = Bitte geben Sie einen neuen Dateinamen ein
Create file failure! = Dateierzeugung fehlgeschlagen!
Schematics and PCBs can't be imported under My Libs folder, please choose a different folder = Schaltpläne und Leiterplatten können nicht im Ordner My Libs importiert werden, bitte wählen Sie einen anderen Ordner
Libraries to be imported under My Libs folder = Bibliotheken müssen in „Meine Bibliotheken“ Ordner importiert werden
Please choose only the libraries needed = Bitte wählen Sie nur die Bibliotheken die Sie benötigen
Maximum import is 200 libs at one time! = Maximal 200 Bibliotheken zur gleichen Zeit importieren
You libraries will be found under the My Libs folder = Ihre Bibliotheken finden Sie in „Meine Bibliotheken“ Ordner
Add to Library = Zu Bibliothek hinzufügen
No items have been checked! = Es wurden keine Artikel geprüft!
Nothing was found, please create it for yourself = Es wurde nichts gefunden, bitte erzeugen Sie diese selber
Search result = Suchergebniss
At least 3 characters needed = Es werden mindestens 3 Zeichen benötigt
Add to my Favorite Parts = Zu meinen bevorzugten Teilen hinzufügen
Added it OK. Please find it in your Favorite Parts = Erfolgreich hinzugefügt. Bitte suchen Sie Sie in Ihren „Bevorzugten Teilen“
Please select its parent node = Bitte wählen Sie den Hauptnetzknoten
Libraries can not be exported as active project pdf. = Bibliotheken können nicht wie aktive Projekt PDFs exportiert werden.
Error:No GND = Fehler:Keine GND
This circuit does not have GND. Please select GND from the circuit tool to add to the circuit. = Diese Schaltung hat kein GND. Bitte wählen Sie GND aus dem Schaltungstool aus, um sie der Schaltung hinzuzufügen.
Current circuit doesn't has Voltage Resource or Current Resource symbol, please place it first at left side EElib or Spice Library. = Der Stromkreis hat kein Spannungsressourcen- oder Stromressourcensymbol, bitte platzieren Sie es zuerst auf der linken Seite der EElib oder der Spice Bibliothek.
Probe can not connect with ground(GND)! = Sonde kann nicht mit Masse (GND) verbunden werden!
Spice symbols's properties can't be empty. = Die Property von Spice Schaltsymbolen dürfen nicht leer sein.
Error:No Spice Symbol = Fehler:Kein Spice Schaltsymbol
Simulation limit = Simulationsgrenze
There is a multimeter in the circuit that needs to be simulated using the emulation command .tran or .op = In der Schaltung befindet sich ein Multimeter, das mit dem Emulationsbefehl .tran oder .op . simuliert werden muss
An oscilloscope exists in the circuit and needs to be simulated using the simulation command .tran =
There are components in this circuit that do not have a simulation model. Please use the base library component of the simulation mode for simulation. = Es gibt Komponenten in dieser Schaltung, die kein Simulationsmodell haben. Bitte verwenden Sie für die Simulation die Basisbibliothekskomponente des Simulationsmodus.
Circuit does not have a probe = Schaltung hat keine Meßspitze
Make sure your pin numbers are even numbers = Stellen Sie sicher das die Pinummern gerade sind
Duplicate Components Prefix = Doppelte Komponenten Vorsilbe
All components are hidden successfully! = Alle Komponenten wurden erfolgreich ausgeblendet!
All ratlines are hidden successfully! = Alle Verdrahtungslinien wurden erfolgreich ausgeblendet!
Hidden the ratline of net {netName} successfully! = Versteckten von Verdrahtungslinie Netz {netName} erfolgreich!
Duplicate Component Prefix = Doppelte Komponenten Vorsilbe
{0} exist = {0} existiert
There are some invalid packages, are you sure? = Es gibt einige ungültige Pakete, sind Sie sicher ?
Invalid Characters, library only allows [0-9a-zA-Z-_] = Ungültige Zeichen, Bibliothek erlaubt nur [0-9a-zA-Z-_]
Annotation success = Anmerkung erfolgreich
If you accept this annotation operation, please save your files. If not, close your files without saving. = Wenn Sie die Änderung dieser Anmerkung akzeptieren, speichern Sie bitte Ihre Datei. Wenn nicht, schließen Sie diese Datei ohne zu speichern.
This file can't be saved under libs project. Please choose other project or create a new project = Diese Datei kann nicht im libs Projekt gespeichert werden. Bitte wählen Sie ein anderes Projekt oder erstellen Sie ein neues Projekt
Your file is unsaved. = Ihre Datei wurde nicht gespeichert.
You can close the editor now. Have a good day! = Sie können den Editor jetzt schließen und haben Sie noch einen schönen Tag!
Successfully logged out = Erfolgreich ausgeloggt
You have at least one unsaved file open. Please save it or close it. = Sie haben mindestens eine nicht gespeicherte Datei geöffnet. Bitte speichern oder schließen.
Please select a reference point = Bitte wählen Sie einen Referenzpunkt
Please save your file before this operation = Bitte speichern Sie Ihre Datei vor diesem Vorgang
Please open a PCB document = Bitte öffnen Sie ein Leiterplatten Dokument
Please save your file before '{0}'. = Bitte speichern Sie Ihre Datei vor '{0}'.
Please try again after saving this file. = Versuchen Sie es nochmal nachdem Sie die Datei gespeichert haben.
This text can not be empty! = Dieser Text darf nicht leer sein!
Export to Altium fail, please try again or contact us. = Export nach Altium fehlgeschlagen, bitte versuchen Sie es erneut oder kontaktieren Sie uns.
Connecting to server = Verbinden zum Server
Please login before asking for help = Bitte loggen Sie sich zuerst ein bevor Sie nach Hilfe fragen
This file has been modified, please save it first! = Die Datei wurde verändert, bitte speichern Sie Sie zuerst!
Remove this param = Entferne diesen Parameter
You cannot drag a part to the canvas, please click the part and move the cursor to the canvas and then right-click to place. = Sie können ein Teil nicht auf die Zeichnung ziehen, klicken Sie bitte auf das Teil, bewegen Sie den Cursor auf die Zeichnung und klicken Sie dann mit der rechten Maustaste, um es zu platzieren.
Undo/Redo temporary error = Rückgängig/Wiederherstellen vorübergehender Fehler
We are sorry but there is an unpredictable error in the undo/redo process. This problem will be fixed soon but in the meanwhile it is safe to continue working on your design. = Es tut uns leid, aber beim Rückgängig-/Wiederherstellen Vorgang ist ein unvorhersehbarer Fehler aufgetreten. Dieses Problem wird in Kürze behoben, aber in der Zwischenzeit können Sie sicher weiter an Ihrem Design arbeiten.
The schematic has duplicate prefixes of the components, please make them unique. You can check them using the Design Manager. = Der Schaltplan hat doppelte Vorsilben der Komponenten, bitte machen Sie sie eindeutig. Sie können sie mit dem Design Manager überprüfen.
Found duplicated prefix components, can not Import Changes, please modify the duplicated prefix or delete related component. = Doppelte Vorsilben an Komponenten gefunden, Änderungen können nicht importiert werden. Bitte ändern Sie die doppelten Vorsilben oder löschen Sie die zugehörige Komponente.
Please click the below help button to find out how to fix this problem. = Bitte klicken Sie auf die unten stehende Hilfeschaltfläche, um zu erfahren, wie Sie dieses Problem beheben können.
Please create a board outline! Click the help button to find out how to create a board outline. = Bitte erstellen Sie eine Leiterplatten Umriss! Klicken Sie auf die Schaltfläche Hilfe, um zu erfahren, wie Sie eine Leiterplattenkontur erstellen.
Can not fetch files from server, please check your network and try again = Dateien können nicht vom Server abgerufen werden. Bitte überprüfen Sie Ihr Netzwerk und versuchen Sie es erneut
Please open a schematic first! = Bitte zuerst einen Schaltplan öffnen!
Can not find the schematic of this PCB = Kann den Schaltplan dieser Leiterplatte nicht finden
invalid points! = ungültige Punkte!
This file does not support this operation. = Diese Datei unterstützt diesen Vorgang nicht.
Net Name Conflict = Konflikt mit einem Netznamen
Net name = Netzname
{0} are in the same wire, please remove others and just keep one. = {0} befinden sich in der selben Leitung, bitte entfernen Sie andere und behalten Sie nur eine.
This field can't be removed! = Dieses Feld kann nicht entfernt werden.
Annular ring of the pad/via is too small = Ring des Pads/Durchkontaktierung ist zu klein
The size of the hole cannot exceed the size of the pad = Die Größe des Lochs darf die Größe des Pads nicht überschreiten
Are you sure you want to create a multi-sheet designs? = Möchten Sie wirklich ein Design mit mehreren Seiten erstellen?
Are you sure you want to create a {0}multi-sheet designs{1}? = Möchten Sie wirklich ein {0}Design mit mehreren Seiten{1} erstellen?
Please build the copper area! Click the help button to find out how to build the copper area. = Bitte den Kupferbereich bauen! Klicken Sie auf die Schaltfläche Hilfe, um zu erfahren, wie Sie den Kupferbereich erstellen.
Suggest to set a package for this component first! = Schlagen Sie vor, zuerst ein Paket für diese Komponente festzulegen!
Please select an opened document first. = Bitte wählen Sie zuerst ein geöffnetes Dokument aus.
Some files failed to load. Please reload the page. = Einige Dateien konnten nicht geladen werden. Bitte laden Sie die Seite neu.

#UI Intro
Skip = Überspringen
« Back = « Zurück
Next » = Weiter »
Done = Fertig
This is the user management menu. = Das ist das Benutzerverwaltungsmenü.
This is the toolbar. = Dies ist die Symbolleiste.
This is the navigation list. Under here you can find projects, files, parts and libraries. = Das ist die Navigationsleiste. Hier können Projekte, Dateien, Teile und Bibliotheken gefunden werden.
Show or hide the toolbar to the top of the window here. = Blenden Sie hier die Symbolleiste oben im Fenster ein oder aus.
Show, resize or hide the left sidebar to the left of the window here. = Zeigen Sie hier die linke Seitenleiste links vom Fenster an, ändern Sie die Größe oder blenden Sie sie aus.
Show or hide the right sidebar to the right of the window here. = Hier die rechte Seitenleiste rechts neben dem Fenster ein- oder ausblenden.

#Standard libs
Passive Components = Passive Komponenten
Power Supply = Netzversorung
Diodes = Dioden
Regulator = Spannungsregler
Transistor = Transistoren
Transformers = Transformatoren
Gates = Gates
Vacuum Tubes = Vacuum Röhren
Switch = Schalter
Relay = Relais
Capacitor(US) = Kondensator(US)
Capacitor(EU) = Kondensator(EU)
Capacitor(EU)2 = Kondensator(EU)2
Electrolytic Capacitor(US) = Elektrolyt Kondensator(US)
Electrolytic Capacitor(EU) = Elektrolyt Kondensator(EU)
Electrolytic Capacitor(US)2 = Elektrolyt Kondensator(US)2
Electrolytic Capacitor(EU)2 = Elektrolyt Kondensator(EU)2
Inductor(US) = Spule(US)
Inductor(EU) = Spule(EU)
Potentiometer_US =
Potentiometer_EU/IEC =
Potentiometer_3D =
Resistor(US) = Widerstand(US)
Resistor(EU) = Widerstand(EU)
Resistor 45 Deg(US) = Widerstand 45 Grad(US)
Resistor 45 Deg(EU) = Widerstand 45 Grad(EU)
Variable Capacitor(US) = Veränderbarer Kondensator(US)
Variable Capacitor(EU) = Veränderbarer Kondensator(EU)
Variable Resistor(US) = Veränderbarer Widerstand(US)
Variable Resistor(EU) = Veränderbarer Widerstand(EU)
Variable Inductor(US) = Veränderbare Spule(US)
Variable Inductor(EU) = Veränderbare Spule(EU)
Varistor = Varistor
Inductor2(US) = Spule2(US)
Inductor2(EU) = Spule2(EU)
Battery = Batterie
Voltage Source = Spannungsquelle
Current Source = Stromquelle
CCCS(Current Controlled Current Source) = CCCS(Strom kontrollierte Stromquelle)
CCCS2(Current Controlled Current Source) = CCCS2(Strom kontrollierte Stromquelle)
VCCS(Voltage Controlled Current Source) = VCCS(Spannungs kontrollierte Stromquelle)
VCVS(Voltage Controlled Voltage Source) = VCVS(Spannungs kontrollierte Spannungsquelle)
CCVS(Current Controlled Voltage Source) = CCVS(Strom kontrollierte Spannungsquelle)
CCVS2(Current Controlled Voltage Source) = CCVS2(Strom kontrollierte Spannungsquelle)

BV(Behavioral Voltage Sources) = BV(Verhaltensabhängige(Spannung) Spannungsquelle)
BI(Behavioral Voltage Sources) = Bi(Verhaltensabhängige(Strom) Spannungsquelle)
Epoly(Non-linear Voltage Source) = Epoly(Nicht lineare Spannungsquelle)
Gpoly(Non-linear Current Source) = Gpoly(Nicht lineare Stromquelle)

Diode = Diode
LED = LED
LED_3D =
Schottky Diode = Schottky Diode
Varactor Diode = Varactor Diode
Zener = Zener
Unidirectional TVS Diode = Unidirectional TVS Diode
Bidirectional TVS Diode = Bidirectional TVS Diode
Diac = Diac
Bridge = Brücke
78XX =
79XX =
LM317 =
LM337 =
TL431 =
BJT(NPN) =
BJT(PNP) =
MOSFET(Nch) =
MOSFET(Nch) Depletion Four-pins =
MOSFET(Nch) Enhancement =
MOSFET(Nch) Enhancement Four-pins =
MOSFET(Pch) =
MOSFET(Pch) Depletion Four-pins =
MOSFET(Pch) Enhancement =
MOSFET(Pch) Enhancement Four-pins =
JFET(Nch) =
JFET(Pch) =
Darlington NPN =
Darlington PNP =
MESFET(Nch) =
MESFET(Pch) =

IGBT =
SCR =
Triac =
Transform(US) = Transformator(US)
Transform(EU) = Transformator(EU)
Transfrom(NEUTRAL-CTR TAP)(US) = Transformator(NEUTRAL-CTR TAP)(US)
Transfrom(NEUTRAL-CTR TAP)(EU) = Transformator(NEUTRAL-CTR TAP)(eu)
Mutual Inductors = gegenseitige Induktivitäten
Mutual Inductors2 = gegenseitige Induktivitäten2
Or Gate =
Xor Gate =
And Gate =
Nor Gate =
Nand Gate =
Not Gate =
Xnor Gate =
Tube Diode = Röhrendiode
Tube Triode = Röhrentriode
Tube Tetrode = Röhrentetrode
Tube Pentode = Röhrenpentode
Voltage Controlled Switch = Spannungs kontrollierter Schalter
Current Controlled Switch = Strom kontrollierter Schalter
SPST ON = SPST EIN
SPST OFF = SPST AUS
Fuse = Sicherung
555 =
555(Style2) =
Speaker = Lautsprecher
XTAL = Quarz
5pin Operational Amplifier = 5pin Operationsverstärker
3pin Operational amplifier = 3pin Operationsverstärker
Transmission Line = Übertragungsleitung
Voltmeter = Spannungsmesser
Ammeter = Amperemeter
LAMP = Lampe
Opto Transistor =

#Server Message
Need login = Anmeldung erforderlich
Bad password = Schlechtes Passwort
We can't find your username or your email, please check it! = Wir können Ihren Benutzernamen oder Ihre E-Mail-Adresse nicht finden, bitte überprüfen Sie es!
Make sure your uploaded file size is less than 3MB! = Stellen Sie sicher, dass die Größe Ihrer hochgeladenen Datei weniger als 3 MB beträgt!
Bad file type = Ungültiger Dateityp
Empty file or bad file type, ensure your file is Eagle 6.0+ = Leere Datei oder fehlerhafter Dateityp, stellen Sie sicher, dass Ihre Datei Eagle 6.0+ ist
This operation not supported on demo account = Dieser Vorgang wird vom Demokonto nicht unterstützt
Can not share this file under a private project, please set the active project to public! = Kann diese Datei nicht unter einem privaten Projekt teilen, bitte setzen Sie das aktive Projekt auf öffentlich!
Login Failed Too many attempts. If you forgot your password, please {0}reset your password{1} or send an email to support@easyeda.com = Anmeldung fehlgeschlagen Zu viele Versuche. Wenn Sie Ihr Passwort vergessen haben, {0}setzen Sie Ihr Passwort zurück{1} oder senden Sie eine E-Mail an support@easyeda.com

#Dialog Common Buttons
Common Buttons Setting = Allgemeine Tasteneinstellung
Menu Setting... = Menüeinstellung...
Show/Hide = Anzeigen/Ausblenden
Move Up = Nach oben verschieben
Move Down = Nach unten bewegen
Reset All = Alles zurücksetzen
Zoom = Zoomen
Place Pin = Pin platzieren

#System Setting Dialog
System =
Zoom Mode = Zoom Modus
Scroll Key = Scroll Taste
CTRL + Scroll =
Canvas Coordinate System = Zeichungs Koordinatensystem
SVG Coordinate = SVG Koordinate
Cartesian Coordinate = Kartesische Koordinaten
Open Wizard Dialog for New Schematic = Assistentendialog für neuen Schaltplan öffnen
Default Unit = Standardeinheit
Canvas Zoom Effect = Zeichnung Zoom Effekt
Quality Priority = Qualitätspriorität
Speed Priority = Geschwindigkeitspriorität
Rotation Step = Rotationsschritt
Add Teardrop Automatically = Kegelförmig automatisch hinzufügen
Assign Net for Free Track/Arc/Circle = Netz für freie Leiterbahn/Bogen/Kreis zuweisen
Open Wizard Dialog for New PCB = Assistentendialog für neue Leiterplatte öffnen
Rebuild Plane Automatically = Lage automatisch neu aufbauen
The Track's Routing Follows Component's Rotation = Das Routing der Leiterbahn folgt der Rotation der Komponente
Display Pad's Number and Net = Nummer und Netz des Pads anzeigen
Favorite Track width = Bevorzugte Leiterbahnbreite
Track Width Setting = Einstellung der Leiterbahnbreite


#Dialog Access Control
Permissions = Berechtigungen
Operations = Betrieb
Access Control = Zugangskontrolle
Project Access Control = Projektzugriffskontrolle
Reject = Ablehnen
Add User = Nutzer hinzufügen
Bad email address = Falsche E-Mail-Adresse
# error info from backend
Can't find this email address in EasyEDA. Your partner must be an EasyEDA user. = Diese E-Mail-Adresse kann in EasyEDA nicht gefunden werden. Ihr Partner muss ein EasyEDA-Benutzer sein.

#Dialog waveForm
Grid Background = Gitter Hintergrund
Pane Background = Fensterhintergrund
WaveForm Config = Wellenform Konfiguration
Export Waveform = Wellenform exportieren


#attr-canvas-grid-style
dot = Punkt
line = Linie

#attr-canvas-frame-size
Other = Andere
A4 Portrait = A4 Hochformat
A4 Landscape = A4 Querformat
A3 Portrait = A3 Hochformat
A3 Landscape = A3 Querformat
A2 Portrait = A2 Hochformat
A2 Landscape = A2 Querformat
A1 Portrait = A1 Hochformat
A1 Landscape = A1 Querformat
Landscape = Querformat
Portrait = Hochformat

#Stroke Style
solid = solide
dashed = gestrichelt
dotted = gepunktet

#Solid Region
Solid Region = Solide Region
Type =
type =

#Dialog Libs Management
Report error = Fehler melden
Please give us some information to help us find the problem. = Bitte geben Sie uns einige Informationen, die uns helfen, das Problem zu finden.
Cannot place parts into this document: Schematic Symbols can only be placed into a Schematic; PCB Footprints can only be placed into a PCB. = Teile können nicht in dieses Dokument eingefügt werden: Schaltplansymbole können nur in einen Schaltplan eingefügt werden; Leiterplatten-Grundflächen können nur in einer Leiterplatte platziert werden.
Save it as a favorite part = Als Lieblingsteil speichern
Only logged-in users can save this component as a Favorite Part but guest (Anonymous) users can place this component into their design directly. Would you like to place this component now? = Nur angemeldete Benutzer können diese Komponente als Lieblingsteil speichern, aber Gastbenutzer (anonym) können diese Komponente direkt in ihr Design einfügen. Möchten Sie dieses Bauteil jetzt platzieren?

#Others
Find libs = Suche Bibliothek
My Projects = Meine Projekte
My Parts = Meine Teile
My Modules = Meine Module
Assembly LCSC Components = Montage von LCSC-Komponenten
Modules = Module
SCH Module = Schaltplan Module
PCB Module = Leiterplatten Module
System IC = System IC
LCSC (Official) =
LCSC Electronics =
Simple Mode = Einfacher Modus
Expand Mode = Erweiterungsmodus
Help Verify = Hilfe bei der Überprüfung
Favorite Parts = Bevorzugte Teile
Shared With Me = Mit mir geteilt
Preview = Voransicht
Preview Window = Vorschaufenster
System Default = System Standard
User Defined = Benutzerdefiniert
Theme = Thema
Theme Setting = Thema Einstellung
Close = Schließen
Open = Öffnen
Toggle toolbar = Werkzeugleiste umschalten
Toggle left bar = Linke Leiste umschalten
Toggle right bar = Rechte Leiste umschalten
Reload = Neuladen
Mouse-X = Maus-X
Mouse-Y = Maus-Y
Mouse-DX = Maus-DX
Mouse-DY = Maus-DY
Bus entry x1 = Datenbus Eingang x1
Bus entry x2 = Datenbus Eingang x2
Bus entry y1 = Datenbus Eingang y1
Bus entry y2 = Datenbus Eingang y2
Yes = Ja
No = No
OK = OK
Confirm = Bestätigen Sie
Continue = Fortsetzen
Cancel = Abrechen
Update = Aktualisieren
Bus entry = Datenbus Einspeisung
Filter = Filter
Check = Überprüfen
Copy the contents of this box into a text editor, then save the file. Paste the edited text back into this box and click Apply to update the display. = Kopieren Sie den Inhalt dieses Felds in einen Texteditor und speichern Sie die Datei. Fügen Sie den bearbeiteten Text wieder in dieses Feld ein und klicken Sie auf Übernehmen, um die Anzeige zu aktualisieren.
Copy the contents of this box into a text editor, then save the file with a .svg extension. You can edit it in Inkscape or open it in your browser. = Kopieren Sie den Inhalt dieses Felds in einen Texteditor und speichern Sie die Datei mit der Erweiterung .svg. Sie können es in Inkscape bearbeiten oder in Ihrem Browser öffnen.
Content is too big to show, you can download it directly. = Der Inhalt ist zu groß zum Anzeigen, Sie können ihn direkt herunterladen.
SVG format = SVG Format
SVG File = SVG Datei
Description should be no more than 250 letters = Die Beschreibung sollte nicht mehr als 250 Buchstaben umfassen
The file save operation has timed out. Try again and check your Internet connection. = Der Vorgang zum Speichern der Datei ist abgelaufen. Versuchen Sie es erneut und überprüfen Sie Ihre Internetverbindung.
Export Netlist = Netzliste exportieren
Notifications = Benachrichtigungen
Please select txt or json files. = Bitte wählen Sie txt- oder json-Dateien aus.
Failed to read file [{file}] = Fehler beim Lesen der Datei [{file}]
[{file}] is not a valid json file = [{file}] ist keine gültige JSON-Datei
Invalid parameters! = Ungültige Parameter!
Download = Herunterladen
Start =
You have unsaved files, are you sure you want to log out without saving the files? = Sie haben nicht gespeicherte Dateien. Möchten Sie sich wirklich abmelden, ohne die Dateien zu speichern?
Please use the web version to run this function. = Bitte verwenden Sie die Webversion, um diese Funktion auszuführen.
Please save this file to you project! = Bitte speichern Sie diese Datei in Ihrem Projekt!
Nothing changed = Nichts hat sich geändert
Delete Node = Knoten löschen
This layer is invisible. = Diese Lage ist unsichtbar.
When the solid region is Board Cutout, please set the layer to Multi-Layer. = Wenn der einfarbige Bereich ein Leiterplatten Ausschnitt ist, stellen Sie die Ebene bitte auf Multi-Layer ein.
You should not try to assign a net to a Board Cutout solid region. = Sie sollten nicht versuchen, einem einfarbigen Bereich des Leiterplatten Ausschnitts ein Netz zuzuweisen.
Net Length = Nettolänge
You can place a Pin in the schematic, but don't forget to group all of the Pins to a schematic component. Please click the help button to find out how to group them. If you just want to mark the wire, please use NetPort or NetLabel. = Sie können einen Pin im Schaltplan platzieren, aber vergessen Sie nicht, alle Pins zu einer Schaltplankomponente zu gruppieren. Bitte klicken Sie auf die Hilfe-Schaltfläche, um zu erfahren, wie Sie sie gruppieren können. Wenn Sie nur den Draht markieren möchten, verwenden Sie bitte NetPort oder NetLabel.
Please input the modification = Bitte geben Sie die Änderung ein
The content must be between {0} and {1} characters = Der Inhalt muss zwischen {0} und {1} Zeichen lang sein

Coming soon = In Vorbereitung
No tool = Kein Werkzeug
Help us translate into your language = Helfen Sie uns, in Ihre Sprache zu übersetzen
Pad = Pad
Via/Hole = Durchkontaktierung/Loch
PCB Layers = Leiterplatten Lagen
Order PCB = Bestelle Leiterplatte
Share = Teilen
Free = kostenlos
Small = Klein
Medium = Mittel
Big = Groß


Embed = Eingebettet
HTML =
URL =
BBCode =
PNG =
Exporting as = Exportieren als
Exporting as image = Exportieren als Bild
Exporting as {0}SVG{1} file. = Exportieren als {0}SVG{1} Datei.
Exporting as pdf is recommended: pdf gives good quality printed output and a small file size. = Der Export als PDF wird empfohlen: PDF liefert eine gute Druckqualität und eine geringe Dateigröße.
Generate PCB Fabrication File(Gerber) = Generieren einer Leiterplatten Fertigungsdatei (Gerber)
PenWidth-Increase = Stiftbreite-Erhöhung

#Generate Gerber
Generate Gerber = Gerber generieren
Gerber View = Gerber-Ansicht
Dimensions(Estimated) = Abmessungen (geschätzt)
PCB Qty = Leiterplatte Menge
Copper Weight = Kupfergewicht
PCB Price = Leiterplatte Preis
Estimated Delivery Time = Voraussichtliche Lieferzeit

HASL(with lead) = HASL(mit Blei)
LeadFree HASL-RoHS = Bleifrei HASL-RoHS
ENIG-RoHS =
Would you like to do Design Rule Checking (DRC) before generating the Gerber files? = Möchten Sie vor dem Generieren der Gerber-Dateien ein Designregelprüfung (DRC) durchführen?
Yes, Check DRC = Ja, Designregeln (DRC) prüfen
No, Generate Gerber = Nein, Gerber generieren
This PCB has uncompleted connection(s), do you want to check the connection(s)? = Diese Platine hat unvollständige Verbindungen. Möchten Sie die Verbindung(en) überprüfen?
Yes, Check Connection(s) = Ja, Verbindung(en) prüfen
It will then redirect to the web site of a third-party JLCPCB with which we cooperate. Are you ready? = Es wird dann auf die Website eines Drittanbieters von JLCPCB weitergeleitet, mit dem wir zusammenarbeiten. Sind Sie bereit?
Failed to submit your order, please contact us via support@easyeda.com for help. = Ihre Bestellung konnte nicht gesendet werden. Bitte kontaktieren Sie uns über support@easyeda.com, um Hilfe zu erhalten.
Failed to submit your order, please contact us via QQ 800821856. = Ihre Bestellung konnte nicht gesendet werden. Bitte kontaktieren Sie uns über QQ 800821856.
Order data generated finish, please click OK button and continue. = Bestelldaten generieren ist beendet, bitte auf OK klicken und fortfahren.
[generateGerber]
Layers = Lagen
[/generateGerber]

[version]
Switch = Schalter
[/version]


Export your file, then print it yourself. = Exportieren Sie Ihre Datei und drucken Sie sie dann selbst aus.
Trace width is too small = Leiterbahnbreite ist zu klein
Share = Teile

Images Property = Bild Eigenschaften
Connect Pad to Pad = Vebinde Pad zu Pad
Copper Area = Kupferbereich
Dimension = Abmaße


Please check that you have used Wire and not Line to connect electrical elements. = Bitte vergewissern Sie sich, dass Sie Leitung und nicht Linie verwendet haben, um elektrische Elemente anzuschließen.
PCB Fabrication Prices & capabilities = Leiterplatten-Fertigung Preise & Möglichkeiten
Flip all texts on bottom layer = Alle Texte auf der unteren Lage spiegeln
Create New Document = Neues Dokument erstellen
General Package = Allgemeines Paket
General Packages = Allgemeines Paket
favorite Package = Bevorzugtes Paket
Board Cutout = Leiterplatte Ausschnitt
Surface Mount = Oberflächenmontage
JLCPCB Part Class = JLCPCB Teile Klasse
base = Basis
expand = Erweitert
recommend = Empfohlen
Basic Part = Basis Teil
Extended Part = Erweitertes Teil
Recommended Part = Empfohlenes Teil
smtWeld = smt Schweißen
thtWeld = tht Schweißen
manualWeld = manuell Schweißen
furnaceWeld = Ofen Schweißen
Multi-Layer = Mehrlagig
Markdown Syntax =
Markdown supported =
Read only = Schreibgeschützt
Read/Write = Lesen/Schreiben
More Libraries... = Weitere Bibliotheken...
Decompress failed! = Dekomprimieren fehlgeschlagen!
Load failed! = Laden fehlgeschlagen!
Loading = Wird geladen
No Result = Kein Ergebnis

#Dialog Place Pin in schematic warning
Place Pin in schematic warning = Pin in Schaltplanwarnung platzieren
You can place a Pin in schematic, but don't forget to group all of the Pins to a schematic component, please click the help button to find out how to group them. If you just want to mark the wire, please use NetPort or NetLabel. = Sie können einen Pin im Schaltplan platzieren, aber vergessen Sie nicht, alle Pins zu einer Schaltplankomponente zu gruppieren. Klicken Sie bitte auf die Hilfe-Schaltfläche, um herauszufinden, wie Sie sie gruppieren können. Wenn Sie nur die Leitung markieren möchten, verwenden Sie bitte NetPort oder NetLabel.
I know. Do not show this again. = Ich weiss. Diese Mitteilung nicht mehr anzeigen.

#Extensions Setting
Extensions Setting = Einstellung für Erweiterungen
Remove = Entfernen
Disable = Deaktivieren
Enable = Aktivieren
(Disabled) = (Deaktiviert)
(Enabled) = (Aktiviert)
Load Extension = Lade Erweiterung
Enable or disable will be applied after reload page = Aktivieren oder deaktivieren wird angewendet, nachdem die Seite neu geladen wurde
Your browser cannot run this function. = Ihr Browser kann diese Funktion nicht ausführen.
Your browser mode does not support indexedDB. Some features may not work properly. Are you using Private Browsing Mode? = Ihr Browsermodus unterstützt indexedDB nicht. Einige Funktionen funktionieren möglicherweise nicht richtig. Verwenden Sie den privaten Browsermodus?
Extension Files = Erweiterungsdateien
Extension ID = Erweiterung ID
Select Files = Dateien auswählen

#Scripts
Script = Skript
Scripts = Skripte
Script Content = Skript Inhalt
Load from js file =
UTF-8 encoded js file = Aus js-Datei laden
Description = Beschreibung
description = Beschreibung
Not a *.js file = Keine *.js-Datei
Failed to read file = Datei konnte nicht gelesen werden
System scripts cannot be modified = Systemskripte können nicht geändert werden
Create Subfolder = Unterordner erstellen
Create Script = Skript erstellen
Install Script = Skript installieren
Install = Installieren
Are you sure you want to remove this script? = Möchten Sie dieses Skript wirklich entfernen?
Folder Name = Ordnernamen
Rename = Umbenennen
Please select a script = Bitte wählen Sie ein Skript aus
Failed to load script = Fehler beim Laden des Skripts
Run Script = Skript ausführen
Load Script = Skript laden
Title is required = Titel ist erforderlich
Script content is required = Skriptinhalt ist erforderlich
System Scripts = Systemskripte
User Scripts = Benutzerskripte
You can right click on the tree nodes. = Sie können mit der rechten Maustaste auf die Baumknoten klicken.

#PCB photoView toolbar
Top Side = Oberseite
Bottom Side = Unterseite
With Silk Layer = Mit Beschriftungslage
No Silk Layer = Ohne Beschriftungslage
Photo View = Fotoansicht

#check update
Check Update = Aktualisierung überprüfen
EasyEDA Editor {ver} is released. Would you like to switch to the new version now? = EasyEDA Editor {ver} wird veröffentlicht. Sie möchten jetzt auf die neue Version umsteigen?
LCEDA Editor {ver} is released. Would you like to switch to the new version now? = LCEDA-Editor {ver} wird veröffentlicht. Sie möchten jetzt auf die neue Version umsteigen?
Switch to New Version = Zur neuen Version wechseln
Next Time = Nächstes Mal

#download project dialog
Generating download link... = Download-Link wird erstellt...
Download project now = Projekt jetzt herunterladen

#Import DXF
Import DXF = DXF importieren
Apply Unit = Einheit anwenden
Convert circle to HOLE on BoardOutLine layer = Kreis in LOCH auf BoardOutLine-Lage umwandeln
No shapes found = Keine Formen gefunden
Fail to load the file = Fehler beim Laden der Datei
Please select a DXF file. = Bitte wählen Sie eine DXF-Datei aus.
This feature only works for PCB document. = Diese Funktion funktioniert nur für Leiterplatten-Dokumente.
Select a DXF file = Wählen Sie eine DXF-Datei aus

#Export DXF
Export DXF = DXF exportieren
Plated-Through-Hole Pads = Beschichtete Durchgangsloch Pads
Non-Plated-Through-Hole Pads = Nicht beschichtete Durchgangsloch Pads
Silkscreen = Beschriftungslage
Surface Pad = Oberflächen-Pad

#Data Sync
Data Sync = Datensychronisation
Data Conflicts = Datenkonflikte
Project or Document = Projekt oder Dokument
Cloud-Side = Seite Cloud
Local-Side = Seite Lokal
Decision = Entscheidung
Modified = Modifiziert
Deleted = Gelöscht
As Cloud = Als Cloud
As Local = Als Lokal
Skip = Überspringen
Data sync completed = Datensynchronisation abgeschlossen

#Team
Team = Team
Teams = Teams
Switching team = Team wechseln
Switch team failed = Konnte Team nicht wechseln
Load team info fail! = Konnte Teaminfo nicht laden!
Load team info fail! Please reload. = Konnte Teaminfo nicht laden! Bitte neu laden.
My Teams = Meine Teams
Create Team = Team erstellen

#Dialog Footprint Manager
Footprint Manager = Manager Bauteilgrundflächen
Open Footprint Manager = Öffne Bauteilgrundflächen Verwalter
Schematic Components = Schaltplan Komponenten
Edit Pin Map Information = Pin-Map-Informationen bearbeiten
Package Categories = Paketkategorien
Components List = Komponentenliste
Personal = Persönlich
Component PIN information = Komponenten PIN-Info
Footprint PAD information = Grundfläche PAD-Info
Footprint Categories = Kategorien Grundfläche
Pad Number = Padnummer
Search Footprint = Nach Bauteilgrundfläche suchen
Filter by keyword = Nach Schlüsselwort filtern
System Libs = Systembibliotheken

#dialog global delete
Drawings = Zeichnungen
Netlabel and netFlag = Netlabel und netFlag
Texts = Texte
Wires = Leitungen
Board outlines = Leiterplattenkontur
Footprints = Bauteilgrundflächen
Footprint = Bauteilgrundfläche
Tracks = Leiterbahnen

#dialog board outline settings
Current Size = Momentane Größe
Paramenters = Parameter
Start X: =
Start Y: =
Round Rectangular = Rund Rechteckig
radius = Radius
only number is allowed! = nur Zahl ist erlaubt!
please input valid value of width! = Bitte geben Sie einen gültigen Breitenwert ein
please input valid value of height! = Bitte gültigen Höhenwert eingeben!
please input valid value of radius! = Bitte gültigen Radiuswert eingeben!

#cross probe
The object you selected was not found in other documents. = Das von Ihnen ausgewählte Objekt wurde in anderen Dokumenten nicht gefunden.
No valid object for cross probe selected. = Kein gültiges Objekt für Meßspitze ausgewählt.
Can not probe. Refreshing the window may get it to work. = Kann nicht Messen. Das Aktualisieren des Fensters kann dazu führen, dass es funktioniert.
You need to login for this function to work. = Sie müssen sich anmelden, damit diese Funktion funktioniert.

#About Dialog
An Easier EDA Experience =
Version =
BuiltDate =

#Auto Router Dialog
Auto Router Config = Konfiguration Autorouter
General Options = Allgemeine Optionen
All Layers = Alle Lagen
Configure = Konfigurieren
Sorry, your web browser does not support this feature. Please run a modern browser. = Funktion wird durch den aktuellen Browser nicht untersützt. Bitte Browser wechseln.
Please make sure all objects with net are inside the board outline! = Bitte sicherstellen dass alle Objekte mit einem Netz innerhalb der Platine (BoardOutline) sind!
Cannot start again before previous activity is stopped = Eine vorige Aktion steht noch aus
Please select a net = Bitte ein Netz auswählen
TrackWidth cannot be empty = Leiterbahnbreite darf nicht Leer sein
Clearance cannot be empty = Abstand darf nicht Leer sein
Router is time out. = Zeitüberschreitung während dem Routing.
Server is busy, please try again later. = Server ist ausgelastet, bitte später erneut versuchen.
Due to the limitation of {0}router server{1} resources, multiple routers executing concurrently are not supported, please try again later or do it manually :-) = Aufgrund der Beschränkung der {0}Router-Server{1}-Ressourcen werden mehrere gleichzeitig ausgeführte Router nicht unterstützt. Bitte versuchen Sie es später erneut oder tun Sie es manuell :-)
Track Width is invalid = Leiterbahnbreite ist ungültig
General Clearance is invalid = Allgemeiner Abstand ist ungültig
SMD Clearance is invalid = SMD-Abstand ist ungültig
Diameter is invalid = Durchmesser ist ungültig
Drill Diameter is invalid = Bohrdurchmesser ist ungültig
Track width cannot be less than Design Rule Checking (DRC) setting value. = Leiterbahnbreite darf nicht kleiner als in den Designregeln (DRC) definierte Wert sein.
General Clearance cannot be less than Design Rule Checking (DRC) setting value. = Allgemeiner Abstand darf nicht kleiner als in den Designregeln (DRC) definierte Wert sein.
SMD Clearance cannot be less than Design Rule Checking (DRC) setting value. = SMD-Abstand darf nicht kleiner als in den Designregeln (DRC) definierte Wert sein.
Hole size cannot be less than Design Rule Checking (DRC) setting value. = Lochgrösse darf nicht kleiner als der in den Designregeln (DRC) definierte Wert sein.
Design Rule's via diameter must be larger than via drill diameter = Durchkontaktierungs Druchmesser in den Designregeln (DRC) muss grössere als Durchkontaktierungs Bohrdurchmesser sein.
Clearance cannot be less than Design Rule Checking (DRC) setting value. = Abstand darf nicht kleiner als der in den Designregeln (DRC) definierte Wert sein.
Not a valid PCB, please check it again = Keine gültige Leiterplatte, bitte überprüfen.
Previous connection must be closed = Vorherige Verbindung muss geschlossen werden
Network error. Please try again. = Netzwerkfehler, bitte später erneut versuchen.
Router error. = Routerfehler.
Invalid PCB. = Ungültige Leiterplatte
General Clearance = Genereller Abstand
SMD Clearance = SMD-Abstand
#Ripup Nets
Skip Routed Nets = Geroutete Netze überspringen
Remove Existing Tracks = Existierende Leiterbahnen entfernen
Real-time Display = Anzeige (Echtzeit)
Router Layers = Routerlagen
Via = Durchkontaktierung
Special = Spezial
Special Nets = Spezial-Netze
Skip Nets = Netze überspringen
Router Server = Server für Router
Local = Lokal
Cloud = Cloud
Available = Verfügbar
Unavailable = Nicht verfügbar
Checking = Überprüfe
Install Local Auto Router = Auto Router lokal installieren
Checking local auto router server... =  Überprüfe lokalen Autorouter Server
Stop Router = Router stoppen
Auto Router is running... = Autorouter ist am laufen...

#Left Sidebar
EELib =
Basic = Basis
Extend = Erweitern
Design Manager = Design Manager
Library = Bibliothek
Spice Library = Spice Bibliothek
Shared = Geteilt
LCSC =
LCSC Parts = LCSC-Teile
Supply Flag = Versorgungsmakierung
US =
EU/IEC =
US Style = US Stil
Resistor = Widerstand
Capacitor = Kondensator
Inductor = Induktivität
Switch/Key = Schalter/Taste
EU/IEC Style = EU/IEC Stil
CN =
Connector = Verbinder
Switch/Relay = Schalter/Relais
JLCPCB =
Recycle Bin = Papierkorb

# Protractor
Font Height = Schriftarthöhe
Precision = Präzision
Protractor = Winkelmesser

#attr-pcbtext-line-width
Only default font family supports to change font width. = Nur die Standardschriftfamilie unterstützt das Ändern der Schriftbreite.
Font is missing! You can confirm the dialog and use default font instead or cancel the dialog then upload your font and do it again. = Schriftart fehlt! Sie können das Dialogfeld bestätigen und stattdessen die Standardschriftart verwenden oder das Dialogfeld abbrechen, dann Ihre Schriftart hochladen und es erneut tun.

#Common
Owner = Eigentümer
License = Lizenz
Part Pins = Teil-Pins
Net Pins = Netzpins
Net Ratlines = Netzleitungen
Add Parameter = Parameter hinzufügen
Histories record = Historienaufzeichnung
Create Team = Team erstellen
Can't find this footprint on the server, please re-associate it. = Kann diese Bauteilgrundfläche auf dem Server nicht finden, bitte neu zuordnen.
The footprint name associated with the component and the footprint name on the server are inconsistent, please re-associate it. = Der mit der Komponente verbundene Bauteilgrundflächenname und der Bauteilgrundflächenname auf dem Server sind inkonsistent, bitte neu zuordnen.
The symbol pin number(s) of the component does not match the associated footprint pad number(s), please modify the symbol pin number(s) or re-associate the footprint = Die Schaltzeichen Pinnummer(n) der Komponente stimmen nicht mit der/den zugeordneten Bauteilgrundflächen-Pad-Nummer(n) überein, bitte ändern Sie die Schaltzeichen Pinnummer(n) oder ordnen Sie die Bauteilgrundfläche neu zu
No footprint, please associate the footprint first. = Keine Bauteilgrundfläche, bitte zuerst die Bauteilgrundfläche zuordnen
Can't find the package = Kann das Paket nicht finden
The path is for the project URL identify, it is unique (the identity of the project owned by the user cannot be the same) = Der Pfad dient zur Identifizierung der Projekt-URL, er ist eindeutig (die Identität des Projekts, das dem Benutzer gehört, kann nicht identisch sein)
It's with a letter or a number and can contain only numbers, letters, line-through, underscores, and points. It cannot be modified after saving. = Es besteht aus einem Buchstaben oder einer Zahl und kann nur Zahlen, Buchstaben, Durchstriche, Unterstriche und Punkte enthalten. Sie kann nach dem Speichern nicht geändert werden.
Updating document to new format, please wait......After finishing please save your document with Ctrl + S. = Aktualisieren des Dokuments auf ein neues Format, bitte warten......Nach Abschluss speichern Sie Ihr Dokument bitte mit Strg + S.
Open at current project? = Bei aktuellem Projekt öffnen?
Please select a history to recover. = Bitte wählen Sie einen wiederherzustellenden Verlauf aus.
Be careful! When you click the "Recover" button, this sheet will be overwritten! = Vorsichtig sein! Wenn Sie auf die Schaltfläche "Wiederherstellen" klicken, wird dieses Blatt überschrieben!
Recover = Wiederherstellung
There is no PCB under this project, would you like to create one? = Es gibt keine Leiterplatte unter diesem Projekt, möchten Sie eine erstellen?
Please make sure that the chose Altium Designer files are saved as ASCII files. = Bitte stellen Sie sicher, dass die ausgewählten Altium Designer-Dateien als ASCII-Dateien gespeichert werden.
Export to Altium function is currently in beta: = Die Funktion "Export nach Altium" befindet sich derzeit in der Beta-Phase:
1. Please be sure to read the notice before exporting: = 1. Bitte lesen Sie den Hinweis vor dem Export:
Export Altium notice and disclaimer = Hinweis und Haftungsausschluss zum Export von Altium
2. Please be sure to check again after export! = 2. Bitte nach dem Export noch einmal prüfen!
I have read and agree = Ich habe gelesen und stimme zu
Export to Altium = Export nach Altium
Please make sure that the chose Eagle files are saved in Eagle v6.0 and above. = Bitte stellen Sie sicher, dass die ausgewählten Eagle-Dateien in Eagle v6.0 und höher gespeichert sind.
Please make sure that the Kicad files were compressed as the .zip file. = Bitte stellen Sie sicher, dass die Kicad-Dateien als .zip-Datei komprimiert wurden.
Open Altium Designer file = Öffnen Sie die Altium Designer-Datei
The more information please refer at : = Weitere Informationen finden Sie unter:
Please use Gerber file instead of exporting Altium if you are going to do PCB manufacturing. All PCB factories support the Gerber file. Is it ok to Generate the Gerber file? = Bitte verwenden Sie die Gerber-Datei, anstatt Altium zu exportieren, wenn Sie Leiterplatten herstellen möchten. Alle PCB-Fabriken unterstützen die Gerber-Datei. Ist es in Ordnung, die Gerber-Datei zu generieren?
Yes, Generate Gerber = Ja, Gerber generieren
No, Export Altium = Nein, Altium exportieren
Open Eagle file = Eagle Datei öffnen
Open Kicad file = Kicad Datei öffnen
Select file(s) = Datei(en) auswählen
Append to current project? = An aktuelles Projekt anhängen?
Append = Anhängen
Open as new project = Als neues Projekt öffnen
Tip: Press {0}SPACE{1} or {2}R{3} to rotate the placing object or selected object. = Tipp: Drücken Sie {0}SPACE{1} oder {2}R{3}, um das Platzierungsobjekt oder das ausgewählte Objekt zu drehen.
Hotkeys Setting = Schnelltasten Einstellung
I know. Don't show this again. = Ich weiß. Zeigen Sie dies nicht noch einmal.
Manufacturer Part Number can not be less than 2 characters. = Die Hersteller-Teilenummer darf nicht weniger als 2 Zeichen lang sein.
This prefix was changed to non-subpart format. = Diese Vorsilbe wurde in ein Nicht-Unterteil-Format geändert.
Save as New Project = Als neues Projekt speichern
Save to Existing Project = In bestehendem Projekt speichern
Sheet Setting = Seiten Einstellung
Sheet Size = Blattgröße
Pre = Vor
pre = vor
Invalid Data = Ungültige Daten
Others = Andere
You are not authorized to share this project. = Sie sind nicht berechtigt, dieses Projekt zu teilen.
This project is private: if you continue sharing it will be made public. = Dieses Projekt ist privat: Wenn Sie mit der Freigabe fortfahren, wird es öffentlich gemacht.
Modify file info = Dateiinfo ändern
Please input search keyword = Bitte Suchbegriff eingeben
Sort Projects by = Projekte sortieren nach
Date Created = Datum erstellt
Date Modified = Datum geändert
Title = Titel
Ascending = Aufsteigend
Descending = Absteigend
Pin to Top = Oben anpinnen
Unpin from Top = Von der Spitze lösen
Collapse / Expand = Einklappen / Ausklappen
Expand = Einklappen
Collapse = Ausklappen
Expand All = Alles Ausklappen
Collapse All = Alles Einklappen
Your file hasn't been saved, do you want to save it? = Ihre Datei wurde nicht gespeichert. Möchten Sie sie speichern?
Don't Save = Nicht speichern
Library Owner: = Bibliotheksinhaber:
verifyPkg.Value =
State = Status
Please select! = Bitte auswählen!
Route =
Import successfully: = Erfolgreich importieren:
Import failed: = Importieren fehlgeschlagen:
The title length must be between 2~128 characters. = Die Titellänge muss zwischen 2~128 Zeichen betragen.
Path only contain 'a-z、A-Z、- 、 _ 、0-9'! = Pfade enthalten nur 'a-z A-Z 0-9'!
Path must begin as 'a-z、A-Z、0-9'! = Path must begin as 'a-z A-Z 0-9'!
The path length must be between 4~128 characters! = Die Pfadlänge muss zwischen 4~128 Zeichen betragen!
The title length must be between 2~256 characters! = Die Titellänge muss zwischen 2~256 Zeichen betragen!
The title cannot be less than 3 characters! = Der Titel darf nicht weniger als 3 Zeichen umfassen!
Do you want to delete this file? = Möchten Sie diese Datei löschen?
Add sub part success = Unterteil erfolgreich hinzufügen
Please input name and prefix! = Bitte Name und Vorwahl eingeben!
Board outlines are not closed = Boardumrisse sind nicht geschlossen
Import Altium file fail, the file needs to be an ASCII file encoded in UTF-8. = Altium-Datei importieren schlägt fehl, die Datei muss eine in UTF-8 codierte ASCII-Datei sein.
The Pins "{0}" are not snapped on the grid point! This part maybe will cause some errors in the schematic. = Die Pins "{0}" werden nicht am Gitter eingerastet! Dieser Teil wird möglicherweise einige Fehler im Schaltplan verursachen.
Check Pin = Pin prüfen
Failed to read {0} = Fehler beim Lesen von {0}
{0} is invalid = {0} ist ungültig
{0} not found = {0} nicht gefunden
Failed to execute script: = Skript konnte nicht ausgeführt werden:
One or more js files not found = Eine oder mehrere js-Dateien nicht gefunden
Only ONE {0} file is required = Es ist nur EINE {0} Datei erforderlich
Extension ID is required = Erweiterungs-ID ist erforderlich
Extension ID is invalid = Erweiterungs-ID ungültig
Extension ID is duplicated = Erweiterungs-ID ist doppelt
No Result! = Kein Ergebnis!
Load Error = Ladefehler
loading = Wird geladen
Failed to load spice data = Spice Daten konnten nicht geladen werden
Netlist = Netzliste
Tags = Stichworte
Pin Information: = Pin-Informationen:
Format incorrect, please check for the extra spaces or commas! = Falsches Format, bitte überprüfen Sie die zusätzlichen Leerzeichen oder Kommas!
Round Radius = Runder Radius
Keyword: = Stichwort:
Image = Bild
Image copied. = Bild kopiert.
Copy failed. = Kopieren fehlgeschlagen
Copy success. =
Image Property = Bildattribut
Locked = Gesperrt
Unlock All = Alle freischalten
Unlock = Freischalten
Lock = Sperren
Please input pin name and pin number! = Bitte Pinname und Pinnummer eingeben!
Left-Hand Panel = Linkes Bedienfeld
Right-Hand Panel = Rechtes Bedienfeld
Update All = Alle aktualisieren
The pin number(s) can't find the same pad number(s) = Die Pin-Nummer(n) können nicht die gleiche(n) Pad-Nummer(n) finden
Designator = Bezeichner
Replace = Ersetzen
Update failed =
Successfully updated =
Update failed! = Update fehlgeschlagen
Successfully updated! = Erfolgreich aktualisiert!
Successfully updated {0} component(s)! = {0} Komponente(n) erfolgreich aktualisiert!
Change = Ändern
Check Footprints = Bauteilgrundflächen prüfen
Network Error! = Netzwerkfehler!
Find Similar Objects = Ähnliche Objekte finden
Current Sheet = Aktuelle Seite
All Sheets = Alle Seiten
Kind = Nett
Range = Bereich
Net Label/Net Flag/Net Port/Voltage Probe = Netzname/Netzmakierung/Netzport/Spannungsmesser
Bezier/Freehand Draw = Bezier/Freihand-Zeichnen
Arc/Pie = Bogen/Kuchen
Objects Properties = Objektattribute
Any = Irgendein
Same = Dasselbe
Different = Unterschiedlich
Circular = Kreisförmig
Expose Copper = Kupfer freilegen
"{0}" font is missing. Please add the font to the font family list. = Die Schriftart "{0}" fehlt. Bitte fügen Sie die Schriftart der Liste der Schriftfamilien hinzu.
Place Component = Komponente platzieren
Delete Segment = Segment löschen
Angle = Winkel
Board Thickness = Leiterplattenstärke
Layer Distance = Lagenabstand
Silk Screen = Beschriftungslage
Surface Finish Color = Farbe des Oberflächenfinishs
Colors = Farben
Board Color = Leiterplattenfarbe
Board Side = Leiterplattenseite
Silk Screen = Beschriftungslage
Silk Screen Color = Farbe Beschriftungslage
Display = Anzeige

# Array and Clone
Distribute Array = Array verteilen
Array Type = Array-Typ
Matrix Array =
Circular Array = Kreisförmig Array
Item Rotation = Artikeldrehung
Location = Standort
Items per Column = Elemente pro Spalte
Items per Row = Elemente pro Reihe
# Column Spacing
# Row Spacing
Spacing(Degrees) = Abstand (Grad)
Start Degree = Start Grad
Rotate Item to Match = Artikel entsprechend drehen
Clockwise = Im Uhrzeigersinn
Anti-Clockwise = Gegen den Uhrzeigersinn
Distribute by = Verteilen nach
Column = Spalte
Row = Reihe
Array Clone = Array-Klon
Number of Rows = Reihenanzahl
Number of Columns = Anzahl der Spalten
Number of Copies = Anzahl der Kopien
Distribute Range(Degrees) = Bereich verteilen (Grad)

# Theme color dialog
BusEntry = Datenbus Einspeisung
Foreground = Vordergrund
Common Used = Häufig verwendet
Original Theme = Ursprüngliches Thema
Theme Setting = Themeneinstellung
Change the theme colors of your design = Ändern Sie die Designfarben Ihres Designs
White on Black = Weiß auf Schwarz
Black on White = Schwarz auf weiß
Custom Theme = Benutzerdefiniertes Thema
Color Setting = Farbeinstellung
Apply Setting = Einstellung anwenden
Theme Setting... = Themeneinstellung...
Bus Entry = Datenbus Einspeisung
Foreground = Vordergrund
Symbol Graphics = Schaltplan Grafiken
Common Used = Häufig verwendet
Draw = Zeichnen
Sheet = Seite
The original theme only works for placing the new symbols. = Das ursprüngliche Thema funktioniert nur zum Platzieren der neuen Symbole.
Selection Highlight = Auswahlhervorhebung
Net Label / Port = Netzname / Port

My Theme = Mein Thema
My Theme Settings = Meine Thema Einstellungen
Apply 'Custom Theme' On = „Benutzerdefiniertes Thema“ anwenden auf
Creating New Schematic = Erstellen eines neuen Schaltplans
Opening Existed Schematic = Vorhandenen Schaltplan öffnen
Please fill in all parameters! = Bitte alle Parameter ausfüllen!
Convert to Board Cutout = In Leiterplattenausschnitt umwandeln
Prefix Position = Vorsilben Position
Name Position = Name Position
Center = Mitte
Top = Oben
Bottom = Unten
Left = Links
Right = Rechts
Does not support multiple objects to convert to Board Cutout at the same time = Unterstützt nicht mehrere Objekte zum gleichzeitigen Konvertieren in Board Cutout
Does not support multiple objects to convert to pad at the same time = Unterstützt nicht die gleichzeitige Konvertierung mehrerer Objekte in Pad
Convert to Board Cutout = In Leiterplattenausschnitt umwandeln
Convert to Pad = In Pad umwandeln
Convert to Component Shape = In Komponentenform konvertieren
Combine to Continuous Track = Zu kontinuierlichen Leiterbahn kombinieren
Convert to Solid Region = In feste Fläche konvertieren
Substrate =
3D View = 3D-Ansicht
2D View = 2D-Ansicht
Pin Color = Pin Farbe
Name Color = Name Farbe
Number Color = Nummer Farbe
Dot = Punkt

[theme]
Sheet = Seite
[/theme]


#history dialog
[history-dlg]
Number = Nummer
Editor =
[/history-dlg]
View File History = Dateiversionsverlauf anzeigen
Save Time = Zeit der Speicherung

Invalid Format = Ungültiges Format

#Dialog Teardrop
Round Pad / Via = Rundes Pad / Durchkontaktierung
Rectangle / Oval / Polygon Pad = Rechteck / Oval / Polygon Pad
Applying Teardrops = Anwenden Kegelförmige Form
Removing Teardrops = Entfernen Kegelförmige Form
Waiting = Warten
Progressing... = Fortschritte...

No schematic in the project! = Kein Schaltplan im Projekt!

Move Forward = Vorwärts bewegen
Move Backward = Rückwärts bewegen

#Dialog Panelize
V-CUT = V-Schnitt
Stamp Hole = Stempelloch
No Panelize = Keine Panelisierung
Border and Marking = Rand und Markierung
Create Border = Rahmen erstellen
Border Height = Rahmenhöhe
Border Position = Rahmen Position
Create Positioning Holes = Positionierungslöcher erstellen
Create Fiducial Marks = Passermarken erstellen
Top and Bottom = Oben und unten
Left and Right = Links und rechts
Stamp Hole Group - Column = Stempellochgruppe - Spalte
Stamp Hole Group - Row = Stempellochgruppe - Reihe
The number of rows and columns cannot be set to 1 simultaneously = Die Anzahl der Zeilen und Spalten kann nicht gleichzeitig auf 1 gesetzt werden

#edit path point
[editPathPoints-dlg]
Arc(R) = Bogen (R)
Type = Typ
Action = Aktion
add before = Vorher hinzufügen
add after = Nachher hinzufügen
delete = löschen
[/editPathPoints-dlg]

#edit polygon point
[editPolygonPoints-dlg]
Action = Aktion
add before = Vorher hinzufügen
add after = Nachher hinzufügen
delete = löschen
[/editPolygonPoints-dlg]
You have unconfirmed edit! = Sie haben eine unbestätigte Bearbeitung!
Invalid edit! = Ungültige Änderung

#Dialog PCB Information
PCB Information... = Infos Leiterplatte...
Signal Layers = Signallagen
None Signal Layers = Nicht-Signallagen
Pads = Pads
Surface Pads = Oberflächliche Pads
Plated Through-hole Pads = Plattierte, durchgebohrte Pads (PTH)
None Plated Through-hole Pads = Nicht-plattierte, durchgebohrte Pads (NPTH)
Holes = Löcher
Vias = Durchkontaktierungen
Length of Tracks = Leiterbahnlängen
Copper Areas = Kupferbeiche

#Differential Pair Routing
Differential Pair Routing = Differenzielles Paar-Routing
Differential Pair Rule Setting = Einstellung der Differenzpaarregel
Please input track width = Bitte Leiterbahnbreite angeben
Please input clearance = Bitte Abstand angeben
Routing Rules = Routing-Regeln

#Route Length Tuning
Track Length Tuning... = Leiterbahnlängen Optimierung
Tracks with different net or non-track found in current targets. = Leiterbahnen mit unterschiedlichem Netz oder keine Leiterbahnen in aktuellen Zielen gefunden.
Please select the signal tracks to be tuning. = Bitte wählen Sie die abzustimmenden Signalleiterbahnen aus.
The total length exceeds the Design Rule Checking (DRC) constraint, continue ? = Die totale Länge verletzt eine Designregel (DRC) Restriktion. Weiterfahren?
45° Angle = 45° Winkel
90° Angle = 90° Winkel
DRC Track Length : = DRC Leiterbahnlänge:
Current Length : = Aktuelle länge:
Additional Length : = Zusätzliche Länge:
Target Length: = Ziellänge:
Current Length: = Aktuelle Länge:

can not connect to the server = Kann nicht mit dem Server verbinden

#Dialog Copper Area Manager
Copper Area Manager... = Kupferbereiche verwalten...
Copper Area Manager = Manager Kupferbereiche
Order = Bestellung
Name = Name
Layer = Lage
Color = Farbe
Net = Netz
Move Up = Nach oben
Move Down = Nach unten
Apply = Anwenden
Cancel = Abbrechen
Copper Area do not allow self-intersection! = Kupferbereich darf sich nicht mit sich selbst schneiden!
No copper area! = Kein Kupferbereich!
#Dialog report error
Datasheet = Datenblatt
Verification = Verifizierung
Symbol = Symbol
Pad Number = Padnumber
Pad Size = Padgrösse
Remark = Notiz
Correct = Korrekt
Incorrect = Inkorrekt
Submit = Senden
Tip = Tipp
Please select one component = Bitte eine Komponente auswählen
Location X = X-Position
Location Y = Y-Position
Your current browser version may not support some features. Please use the latest version of Chrome or Firefox, or try the desktop client. = Ihre aktuelle Browserversion unterstützt ggf. einige Funktionen nicht. Bitte auf einen modernen Browser oder den Desktop-Client wechseln.
EasyEDA Client = EasyEDA Kunde
LCEDA Client = LCEDA Kunde
Chrome = Chrome
FireFox = Firefox
New Version = Neue Version
Switch Version = Version wechseln
Members = Mitglied
Update Time = Modifiziert am
Editor = Editor
Current Version: = Aktuelle Version:
Select a version to switch = Version zum wechseln auswählen
3D Model = 3D Modell
Board Side = Leiterplattenseite
Display = Anzeige
Copper = Kupfer
Create New Version = Neue Version erstellen
Create new version success! = Neue Version wurde erstellt!
Version Management = Versionsmanagement
Switch success! = Erfolgreich gewechselt!
Please close current version's documents first! = Bitte aktuelle Version des Dokumentes zuerst schliessen
Creator = Ersteller
Create Time = Erstellt am
Fail to connect to server! Please check your internet connection status and try again! = Verbindung mit dem Server unterbrochen. Bitte Verbindung überprüfen und neu versuchen!
Spice Number = Spice Nummer
Create = Erstellen
3D Outline = 3D-Umriss
Cannot create the slot hole via the board outline, please use the following methods: = Das Langloch kann nicht mit dem Leiterplattenausschnitt erstellt werden, bitte verwenden Sie die folgenden Methoden:
Use the solid region and set its type as Board Cutout = Verwenden Sie den ausgefüllten Bereich und legen Sie seinen Typ als Leiterplattenausschnitt fest
Select a Track/Arc, right-click to use the "Convert to Board Cutout" = Wählen Sie eine Leiterbahn/einen Bogen aus, klicken Sie mit der rechten Maustaste, und dann "In Leiterplattenausschnitt konvertieren".
Select all the closed Tracks/Arcs, right-click to use the "Convert to Board Cutout" = Wählen Sie alle geschlossenen Leiterbahnen/Bögen aus, klicken Sie mit der rechten Maustaste, und dann "In Leiterplattenausschnitt konvertieren"
The more information please refer at = Weitere Informationen finden Sie unter
Save "{0}" success! = "{0}" wurde gespeichert!
Save "{0}" failed! = Konnte "{0}" nicht speichern!
Invalid Size = Ungültige Grösse
Processing = In Arbeit
Invalid Size = Ungültige Grösse
NetFlag GND = Netzbezeichnung GND
NetFlag VCC = Netzbezeichnung VCC
NetFlag +5v = Netzbezeichnung +5V
No Useful Data! = Unnütze Daten.
SVG Preview = Vorschau (SVG)
Prefix contains not supported charater(s) ! = Vorsilbe enthält nicht unterstützte(s) Zeichen!
Name contains not supported charater(s) ! = Name enthält nicht unterstützte(s) Zeichen!
Create Grid Path = Gitterpfad erstellen
Please Input Name = Bitte namen angeben
Building Copper Area = Kupferbereich wird erstellt
Processing = In Arbeit
Opening File = Öffne Datei...
Update from Library = Von Bibliothek aktualisieren
Update Footprint = Bauteilgrundfläche aktualisieren
Find footprint(s) have been updated, do you want to update? = Bauteilgrundfläche(n) wurden aktualisiert. Datei ebenfalls aktualisieren?
3D File: = Datei für 3D-Modell:
Model List = Modellliste
Are you sure merge net {0} and net {1}? = Wirklich Netz {0} mit {1} zusammenführen?
Display Footprint = Bauteilgrundfläche anzeigen
Display Footprint Name While Placing Component = Namen der Bauteilgrundfläche beim platzieren der Komponente anzeigen
Annotate Prefix Automatically After Placing Component = Vorsilbe automatisch nach Platzierung einer Komponente beschriften
Program Error, Please Contact Technical Support! = Programmfehler, bitte technischer Support kontaktieren!
Search Engine = Suchmaschine
Keyword to Filter = Nach Schlüsselwort filtern
Normal Mode = Normaler Modus
Expand Mode = Erweiterungsmodus
3D Model Manager = Manager 3D Modelle
3D Model Preview = Vorschau 3D Modell
3D Model = 3D Modell
3DModel = 3DModell
Document = Dokumente

[pcblayer]
3DModel = 3DModell
Document = Dokumente
[/pcblayer]

Adjustment =
View Larger Image = Größeres Bild anzeigen
Previous = Vorherig
Previous Image = Vorheriges Bild
Next Image = Nächstes Bild
Notice: For reference only, please refer to the real product = Hinweis: Bitte echtes Produkt als Referenz angeben
It's under designing, please wait. = Es befindet sich in der Entwurfsphase, bitte warten Sie.
The width of track/arc/circle cannot be less than 0.1mil! = Die Breite der Leiterbahn/des Bogen/Kreises darf nicht weniger als 0.1mil sein!
Clone success ! = Klonen erfolgreich!
Footprint Naming Reference = Bauteilgrundfläche-Benennungsreferenz
3D Model Manager = 3D Modelmanager
Will jump to the Lichuang open source hardware platform (OSHWHub.com) to improve the information and share. Whether to continue? = Wird auf die Open-Source-Hardwareplattform von Lichuang (OSHWHub.com) springen, um die Informationen zu verbessern und zu teilen. Weitermachen?
Will jump to the EasyEDA open source hardware platform (OSHWLab.com) to improve the information and share. Whether to continue? = Springt auf die Open-Source-Hardwareplattform EasyEDA (OSHWLab.com) um, um die Informationen zu verbessern und zu teilen. Weitermachen?
The project content page will open. After adding a description and setting the project to public, you can click the share button to get the share link. = Die Projektinhaltsseite wird geöffnet. Nachdem Sie eine Beschreibung hinzugefügt und das Projekt als öffentlich festgelegt haben, können Sie auf die Schaltfläche zum Teilen klicken, um den Link zum Teilen zu erhalten.
This project is not public, can not view homepage! = Die Webseite kann nicht angezeigt werden: Dieses Projekt ist nicht öffentlich.

[grid]
None = Aus
[/grid]

#lib verify and mounted
This component is verified = Diese Komponente wurde nicht verifiziert
This component is unmounted = Diese Komponente ist unmontiert

#find component
Find Next = Nächste finden
Object not found = Objekt nicht gefunden

#offset Elements
Offset X = X-Offset
Offset Y = Y-Offset
Offset = Offset
Absolute Offset = Absolutes Offset
Relative Offset = Relatives Offset
Absolute Offset... = Absolutes Offset...
Relative Offset... = Relatives Offset...
Reference Point X = X-Referenzpunkt
Reference Point Y = Y-Referenzpunkt

# Inner Plane layer
Rebuild Plane = Ebene neu aufbauen
PlaneZone Properties = Zonenebene Eigenschaften
Change to a plane layer is not allowed during track routing. = Das Wechseln zu einer Ebenenlage ist während des Leiterbahn-Routings nicht erlaubt.
#pcblib rect
Fill = Füllen
Fill Type = Fülltyp
[PlaneZone]
Solid = Vollflächig
[/PlaneZone]

Solid Region do not allow self-intersection! = Vollflächige Region darf sich nicht mit sich selbst schneiden.

The prefix or name or text too far away from the footprint, if you don't want it to show up please make it hidden. = Vorsilbe, Namen oder Texte sind zu weit von der Bauteilgrundfläche entfernt. Bitte manuell ausblenden, falls Sie sie nicht anzeigen möchten.
The prefixes are not allowed to repeat! = Vorsilben dürfen sich nicht wiederholen.
Save failed! The origin of the canvas is not in the graphics! Whether to set the origin automatically? = Speichern fehlgeschlagen! Der Ursprung der Zeichnung liegt nicht in der Grafik! Soll der Ursprung automatisch eingestellt werden?
The origin of the canvas has been set in the graphics now, you can save again. = Der Ursprung der Zeichnung wurde jetzt in der Grafik festgelegt, Sie können erneut speichern.
Backup Project = Sicherung vom Projekt anlegen
Open Project Directory = Projektordner öffnen

{0} items updated = {0} Elemente aktualisiert

The current file {0} has an updated version. Do you want to overwrite it? If you want to open the latest version, please close the current file and reopen it. = Die aktuelle Datei {0} hat eine aktualisierte Version. Diese überschreiten? Falls Nein, bitte das aktuelle Dokument erneut öffnen.
Yes, Overwrite It = Ja, überschreiten
No, Keep It = Nein, beibehalten

Download Client = Kunden herunterladen

Search tutorial、open source projects etc. = Tutorial durchsuchen, Open-Source-Projekte usw.

Go to LCSC and search for = Gehe zu LCSC und suche nach
Go to LCSC = Gehe zu LCSC

Hide Ratline Layer and Keep the Component Prefix When Paste Objects = Verdrahtungslinie ausblenden und Komponentenvorsilbe beim Einfügen von Objekten beibehalten

ALL.layer = Alle.Layer
Copper.layer = Kupfer.Layer
Non-Copper.layer = Nicht-Kupfer.Layer
Other.layer = Andere.Layer

Please enter at least 2 characters! = Bitte mindestens zwei Zeichen angeben!
View Datasheet = Datenblatt anzeigen
View Datasheet... = Datenblatt anzeigen...

The corresponding package or network could not be found in the currently open PCB document = Das entsprechende Package oder Netzwerk konnte im aktuell geöffneten Leiterplatten-Dokument nicht gefunden werden
delete fail = Konnte nicht löschen

[crashRecovery]
Libraries = Bibliotheken
[/crashRecovery]
Canvas origin anomaly! = Quelle der Zeichnung ist fehlerhaft!

Component's Name = Name (Komponente)
Component's Prefix = Vorsilbe (Komponente)
Component's Footprint = Bauteilgrundfläche (Komponente)

[findlib]
Clear = Leeren
Apply Filters = Filter anwenden
Result = Ergebnis
Place = Plazieren
Prev = Vorherige
Next = Nächste
Total {count} Count = Anzahl: {count}
About = Über
Items = Elemente
[/findlib]

Object = Objekt
Layers and Objects = Lagen und Objekte
All = Alle

Add custom = Eigene hinzufügen

Connections = Verbindungen
Attempted: = Versucht:
Completed: = Fertiggestellt:
Failed: = Fehlgeschlagen:
Total Vias: = Anzahl Durchkontaktierungen:

Please confirm moving option = Bitte bestätigen Sie die Umzugsoption
Only this pad = Nur dieses Pad
For this component = Für diese Komponente
View Owner = Inhaber anzeigen
View Detail = Detail anzeigen


# place batch vias
Place Vias = Durchkontaktierungen platzieren
Placing Vias = Durchkontaktierungen werden platziert
Removing Vias = Durchkontaktierungen werden entfernt
Batch Vias for Copper = Durchkontaktierungen für Kupfer abarbeiten
Add/Remove Vias = Durchkontaktierungen hinzufügen/entfernen
Diameter = Durchmesser
Drill Diameter = Bohrdurchmesser
Column Spacing = Abstand Spalten
Row Spacing = Abstand Reihen
Multiple vias have been placed, do you want to rebuild the copper area? = Es wurden mehrere Durchkontaktierungen platziert, möchten Sie den Kupferbereich neu aufbauen?
Remove vias finish, do you want to rebuild the copper area? = Durchkontaktierungen entfernen ist beendet, möchten Sie den Kupferbereich neu aufbauen?
The width of track/arc/circle cannot be less than 0.051mm/2mil/0.002inch! = Die Breite der Leiterbahn / des Bogens / des Kreises darf nicht weniger als 0,051 mm / 2 mil / 0,002 Zoll betragen!
Save fail! Please try again! = Speichern fehlgeschlagen! Bitte versuche es erneut!
Please select a copper outline = Bitte wählen Sie eine Kupferkontur
Can't find copper area at other layers, please add the copper area with the same net at other layer first. = Kann Kupferfläche auf anderen Lagen nicht finden, fügen Sie bitte zuerst die Kupferfläche mit dem gleichen Netz auf einer anderen Lage hinzu.

Add favorite success! = Erfolgreich in Favoriten aufgenommen.
Remove favorite success! = Erfolgreich aus Favoriten entfernt!
Remove favorite failed! = Entfernen aus Favoriten fehlgeschlagen!
Whether if remove favorite? = Aus Favoriten entfernen?
Split by ';' for multi tags = Tags mit ';' trennen.

This size is the determined size! = Diese Größe ist die ermittelte Größe!
The associated pad has been locked = Das assoziierte Pad wurde gesperrt.
Split by space or , for multi tags = Tags mit Leerzeichen oder ',' trennen.

Rotation X = X-Rotation
Rotation Y = Y-Rotation
Rotation Z = Z-Rotation

Some fields are filled invalid data = Einige Felder beinhalten ungültige Werte
start time should be earlier than stop time = Startzeit sollte früher als die Stoppzeit sein
Number of points should be less than 100 in octave variation = Die Anzahl der Punkte sollte weniger als 100 in der Oktavvariation betragen
Start frequency should be less than stop frequency. The suffix meg stands for Mega,m stands for milli = Startfrequenz sollte kleiner als Stoppfrequenz sein. (Suffixe: meg = Mega, m = milli)
Get historical records fail! = Konnte historische Einträge nicht abfragen!
This 3D model didn't create the outlines successfully, please import it again or contact with us. = Dieses 3D-Modell hat die Umrisse nicht erfolgreich erstellt. Bitte neu importieren oder Kontakt mit dem Support aufnehmen.
There is No Tag! = Es wurde keine Stichworte definiert.
Assign successful! = Erfolgreich zugewiesen.
Found footprint's pad number doesn't match the schematic component's pin number, please correct the pad number and try again! = Die Pad-Nummer der gefunden Bauteilgrundfläche stimmt nicht mit der Pin-Nummer der Schaltplankomponente überein. Bitte korrigieren Sie die Pad-Nummer und versuchen Sie es erneut!
Update Property = Property aktualisieren
Please fill in at least 5 words. = Bitte mindestens fünf Wörter angeben
Mouse hovering over the track to highlight the entire network = Das gesamte Netz wird hervorgehebt, sobald die Maus über eine Leiterbahn schwebt.
Net Highlighting While Cursor Hover the Track = Netz beim schweben über einer Leiterbahn hervorheben.
When circle set as "Yes", the Pin length must be more than 6 = Wenn der Kreis auf "Ja" eingestellt ist, muss die Pinlänge mehr als 6 betragen
Hi, I found a problem of your library, this library seems incorrect.\ntitle:{title}\nType:{type}\nlink:{link}\n{content}\nThank you! = Hallo, ich habe ein Problem mit Ihrer Bibliothek gefunden, diese Bibliothek scheint falsch zu sein.\ntitle:{title}\nType:{type}\nlink:{link}\n{content}\nDanke!

Logout fail! Please try again! = Fehler während der Abmeldung!
Logout success! We look forward you to use LCEDA again! = Abmeldung erfolgreich! Bis zum nächsten Mal bei LCEDA!
Logout success! We look forward you to use EasyEDA again! = Abmeldung erfolgreich! Bis zum nächsten Mal bei EasyEDA!
Click to Preview 3D = 3D-Vorschau öffnen
[logoutDialog]
Logout = Ausloggen
[/logoutDialog]

[findlibTag]
All = Alle
[/findlibTag]

Export Pick and Place File = Datei für Pick-and-Place exportieren
Mirror the bottom component's X coordinate (JLCPCB doesn't need) = Spiegeln Sie die X-Koordinate der unteren Komponente (JLCPCB benötigt diese nicht)
Work Space = Arbeitsfläche
Include panelized components' coordinates = Koordinaten der abgeglichenen Komponenten einschließen
Personal Workspace = Persönliche Arbeitsfläche
Work Space - {name} = Arbeitsfläche - {name}
Work Space - Personal = Arbeitsfläche - Personal
Cloning = Klonung

Project Owner = Projektinhaber
Clone Project = Projekt klonen
Homepage = Webseite
Apply for Education Edition = Für Education Edition bewerben
Load Organization failed = Laden der Organisation fehlgeschlagen
Joined = Beigetreten
Favorite = Favorit
This operation will unfavorite this project, do you want to continue? = Dieses Projekt wird von den Favoriten entfernt. Weiterfahren?
View Homepage = Webseite öffnen
Private Project = Privates Projekt
3-7 days = 3 bis 7 Tage
Close Tab = Tab schliessen
Close Other Tabs = Alle anderen Tabs schliessen
Close All Tabs = Alle Tabs schliessen
Open in New Window = In neuem Fenster öffnen
Cursor Snap to Component's Origin or Pad Center While Dragging Component = Cursor beim Ziehen der Komponente am Ursprung oder Pad-Zentrum der Komponente ausrichten
Undefined = Undefiniert
Input = Eingabe
Model Unit = Modelleinheit
File Unit = Dateieinheit
This part contains subparts, please make sure you have checked other subparts before reporting error, do you want to continue? = Dieser Teil enthält Unterteile. Bitte vergewissern Sie sich, dass Sie andere Unterteile überprüft haben, bevor Sie einen Fehler melden. Möchten Sie fortfahren?

[saveAs]
Power = Leistung
[/saveAs]

Assign LCSC Part# = LCSC Partnummer Zuordnen
Unexpected error while converting. Perhaps unsupported file type or program bug. = Unerwarter Fehler beim Konvertierungsprozess.
Found duplicated component IDs, please click "OK" to re-assign component ID automatically, and then save the document and try again. = Duplikate von Komponenten-IDs wurden detektiert. Bitte mit "OK" diese Komponenten-IDs dynamisch neu zuweisen, das Dokument speichern und den Vorgang anschliessend wiederholen.

#electromagneticSimulation
Electromagnetic Simulation... = Elektromagnetische Simulation...
You will upload Gerber to SuperEM for electromagnetic simulation (only upload Gerber, not including account data), do you want to continue? = Eine Gerber-Datei (Exklusiv Kontodaten) wird an SuperEM für eine elektromagnetische Simulation transferiert. Weiterfahren?
SuperEM is a 3-D full-wave electromagnetic simulation and design platform for high-speed PCB circuits and antennas, which is developed by Faraday Dynamics, Ltd. = SuperEM ist ein 3D Vollwellen elektromagnetische Simulations Platform für Hochgeschwindigkeits Leiterplatten Antennen, welche von Faraday Dynamics Ltd. entwickeld wurde.
Visit the SuperEM = SuperEM besuchen
SuperEM User Guide = SuperEM Benutzerhandbuch
Upload Gerber to SuperEM successfully, please click "OK" buttun to continue = Laden Sie Gerber erfolgreich auf SuprEME hoch, klicken Sie bitte auf die Schaltfläche "OK", um fortzufahren

Format = Format
View = Ansichten
Design = Entwurf
Simulation = Simulation
Advanced = Erweitert
Fabrication = Fabrizierung
Check DRC = Designregelprüfung (DRC) überprüfen
Simulation Setting = Simulationseinstellungen
BOM = BOM
PCB Fabrication File(Gerber) = Gerber-Datei
Pick and Place File = Pick-and-Place Datei
Parts Order = Bauelemente bestellen
PCB Order = Leiterplatte bestellen
SIM = SIM
STD = STD
WaveForm = Wellenform

Place Module = Modul platzieren
Please enter identification letters: = Bitte Identifzierungszeichen angeben.
Only support English letters, up to 5. = Nur bis zu 5 englische Zeichen werden unterstützt.

Exist doesn't annotate prefix component(s) in the module, please edit and annotate the unique prefix(s) for component(s) first. = Exist vergibt keine automatisch beschrifteten Vorsilben and die Komponente(n) im Modul. Bitte bearbeiten und kommentieren Sie zuerst die eindeutigen Vorsilben für die Komponente(n).
Opening = Öffnung

Also update track's net (Only applies to circumstance under which prefix/netlabel changes and no component/wire is added or removed) = Auch das Netz der Leiterbahnen aktualisieren (Gilt nur für Umstände, unter denen sich Vorsilbe/Netzname ändert und keine Komponente/Leitung hinzugefügt oder entfernt wird)

# desktop client error feedback
Cannot open online documents on Project Offline mode. = Online-Dokumente können im Projekt-Offline-Modus nicht geöffnet werden.

Please select a project = Bitte Projekt auswählen
Opened Projects = Geöffnete Projekte
Open Project = Offenes Projekt
Close Project = Projekt schliessen
Open All Projects = Alle Projekte öffnen
Close All Projects = Alle Projekte schliessen
Select Owner = Wähle Eigentümer
Select Folder = Wähle Ordner
Select Owner or Folder = Wähle Eigentümer oder Ordner
Select Project = Wähle Projekt
Folder = Ordner
New Folder = Neuer Ordner
New Sub Folder = Neuer Unterordner
Delete Folder = Lösche Ordner
Move Project = Bewege Projekt
Move Folder = Bewege Ordner
# Rename Folder =
Please input the folder name = Bitte geben Sie den Ordnernamen ein
Invalid folder name = Ungültiger Ordnername
Are you sure to delete this folder? = Möchten Sie diesen Ordner wirklich löschen?
Create new folder successfully = Neuen Ordner erfolgreich erstellen
Failed to create new folder = Fehler beim Erstellen eines neuen Ordners
Delete folder successfully = Ordner erfolgreich löschen
Failed to delete folder = Ordner konnte nicht gelöscht werden
Rename folder successfully = Ordner erfolgreich umbenennen
Failed to rename folder = Fehler beim Umbenennen des Ordners
Move folder successfully = Ordner erfolgreich verschieben
Failed to move folder = Ordner konnte nicht verschoben werden
Move project successfully = Projekt erfolgreich verschieben
Failed to move project = Projekt konnte nicht verschoben werden
The folder depth must not exceed {0} levels = Die Ordnertiefe darf {0} Ebenen nicht überschreiten
Failed to add project to folder = Projekt konnte nicht zum Ordner hinzugefügt werden

Doesn't support JLCPCB SMT Service = Unterstützt den JLCPCB SMT-Dienst nicht
{0} for JLCPCB SMT Service = {0} für JLCPCB SMT-Dienst

Reset failed! There are duplicate component prefixes in the current schematic: = Zurücksetzen fehlgeschlagen! Im aktuellen Schaltplan gibt es doppelte Komponenten Vorsilben
Reset failed! There are duplicate component prefixes in the current PCB: = Zurücksetzen fehlgeschlagen! Es gibt doppelte Komponenten Vorsilben in der aktuellen Leiterplatte:
Please modify the component prefixes first to ensure that the component prefix is unique. = Bitte ändern Sie zuerst die Komponenten Vorsilben, um sicherzustellen, dass die Komponenten Vorsilben eindeutig sind.

LCEDA(Standard) - A Simple and Powerful Electronic Circuit Design Tool = LCEDA(Standard) - Ein einfaches und leistungsstarkes Design-Tool für elektronische Schaltungen
EasyEDA(Standard) - A Simple and Powerful Electronic Circuit Design Tool = Ein einfaches und leistungsstarkes Design-Tool für elektronische Schaltungen

#Dialog for Package Custom Data
Please input the data title = Bitte Titel für diese Daten angeben
Data title duplicated = Daten-Titel wurde dupliziert
Cannot be more than {0} characters! = Darf nicht mehr als {0} Zeichen sein!
Only latin alphabets, digits, underscore(_) and hyphen(-) are allowed. = Nur folgende Zeichen sind erlaubt: Lateinisches Alphabet, Nummern, Unterstrich (_), Bindestrich (-)
Invalid value of item {0} = Ungültiger Wert für Element {0}
Update DFM = DFM aktualisieren
Custom DFM Data = Eigene DFM Daten
Saved custom data successfully! = Benutzerdefinierte Daten wurden erfolgreich gespeichert!
Save custom data failed! = Benutzerdefinierte Daten konnten nicht gespeichert werden
Will replace the graphics and custom data of current document, after imported please adjust the 3D model. Continue or not? = Diese Aktion wird Grafiken und Benutzerdefinierte Daten für das aktuelle Dokument ersetzen. Nach Import bitte das 3D-Model wieder anpassen. Fortfahren?
Open footprint "Custom Data" dialog = "Benutzerdefinierte Daten" für diese Bauteilgrundfläche öffnen.

# Create lead shape
Create Lead Shape = Lötform für Leitung erstellen
Base on Pad Center = Auf Pad Mitte basierend
Base on Canvas Origin = Auf Zeichnungs Ursprung basierend
Lead shape = Lötform
Footprint Type = Bauteilgrundfläche Typ
From pad shape = Von Pad Form
Lead length = Lötleitungsslänge
Lead width = Lötleitungsbreite
Lead diameter = Lötdurchmesser
Scaling ratio = Skalierungsverhältnis
Leads creating direction = Lötausrichtung
Auto = Auto
Horizontal = Horizontal
Vertical = Vertikal
Canvas origin to lead edge = Zeichnungsursprung zur Lötkante
Canvas origin to body edge = Zeichnungsursprung zur Körperkante
Lead soldering length = Länge des Lötspur
Lead soldering part diameter = Durchmesser des Lötteils
Component shape object doesn't overlap lead shape object, please check carefully. = Das Komponentenformobjekt überlappt das Lötformobjekt nicht, bitte überprüfen Sie es sorgfältig.
The solder mask expansion of pads ({0},{1}) has a small clearance(less than 0.08mm), it will cause the soldering too short, please modify. = Die Lötmaskenausdehnung der Pads ({0},{1}) hat einen kleinen Abstand (weniger als 0,08 mm), dadurch wird das Löten zu kurz, bitte ändern Sie es.
The paste mask expansion or custom paste mask layer objects of pads ({0},{1}) has a small clearance(less than 0.15mm), it will cause the stencil to create fail, please modify. = Die Maskenerweiterungs- oder benutzerdefinierten Maskenobjekte der Pads ({0},{1}) haben einen kleinen Abstand (weniger als 0,15 mm). Dies führt dazu, dass die Schablone fehlschlägt. Bitte ändern Sie sie.
System footprint must have pad number 1 or A1, please modify the pad number. = System Bauteilgrundfläche muss Pad-Nummer 1 oder A1 vorhanden sein, bitte ändern Sie die Pad-Nummer.
System footprint doesn't allow two or more pad numbers are 1 or A1, please modify the pad number. = Die System Bauteilgrundfläche lässt nicht zu, dass zwei oder mehr Pad-Nummern 1 oder A1 sind, bitte ändern Sie die Pad-Nummer.
Document layer has circle object, but jlcPara's polarity is 0, please check the Custom Data. = Die Dokumentenlage hat ein Kreisobjekt, aber die Polarität von jlcPara ist 0, bitte überprüfen Sie die benutzerdefinierten Daten.
There are exist repeat pad numbers: {padNumber}, please check, if it is correct please ignore this. = Es gibt Wiederholungs-Pad-Nummern: {padNumber}, bitte überprüfen Sie, ob es richtig ist, ignorieren Sie dies bitte.
Can't find the circle at the component marking layer, or this circle doesn't at the same quadrant with the 1st pad, please check whether it is correct. = Kann den Kreis auf der Bauteilmarkierungslage nicht finden oder dieser Kreis befindet sich nicht im gleichen Quadranten mit dem 1. Pad, bitte überprüfen Sie, ob er korrekt ist.

ROUND = RUND
RECTANGLE = RECHTECK
OCTAGONAL = ACHTECKIG
Upper left = Oben links
Lower left = Unten links
Center of Pads = Mitte der Pads
First Pin = Erster Pin
Package Name = Gehäusename
Pins Number = Pin Anzahl
Rows Of Pin = Pinreihen Anzahl
Columns Of Pin = Pinspalten Anzahl
Polarity = Polarität
Pad Shape = Pad-Form
Body Diameter = Körperdurchmesser
Lead Span = Spannweite Lötung
Lead Vertical Span = Vertikale Spannweite Lötung
Body Length = Körperlänge
Body Height = Körpergrösse
Pin Diameter = Pin-Durchmesser
Pin Length = Pin-Länge
Pin Height = Pin-Höhe
Pin Solid Width = Vollflächig Pin Breite
Pin Solid Height = Vollflächige Pin Höhe
Pin Spacing = Abstand Pin
Pin Horizontal Spacing = Horizontaler Abstand Pin
Pin Vertical Spacing = Vertikaler Abstand Pin
ThermalPad = Thermisches Pad
Pad Expansion = Ausdehnung Pad
Custom PasteMask = Eigene Maskierungslage
Fabrication Tolerance = Fabrikationstoleranz
Placement Tolerance = Platzierungstoleranz
FirstPin Position = Position erster Pin
Package Origin = Ursprungspunkt Gehäuse
Expansion Size = Verbreitungsgrösse
Corner = Ecke
Angle = Winkel
Fillet =
Chamfer = Abkanten
Update Preview = Vorschau aktualisieren
Number of pins (left and right) = Anzahl Pins (Links und rechts)
Number of pins (up and down) = Anzahl Pins (Oben und unten)
Reference Use Cases = Anwedungsfälle aus Referenz
Package Type = Gehäusetyp
Capacitance = Kapazität
Resistance = Widerstand
Bidirectional Diode = Bi-Direktionale Diode
Inductance = Induktivität
Crystal Oscillator = Kristalloszillator
Diode = Diode
LED = LED
Fuse = Sicherung
Entity height = Höhe (Entität)
Lead Overhang = Lötüberhang
Lead Thickness = Lötdicke
Unknown mistake = Unbekannter Fehler
Has ThermalVias = Hat Thermische Durchkontaktierungen
Polar Capacitance = Polare Kapazität

Create Component Marking = Bauteilmarkierung erstellen
Create component marking successfully! = Bauteilkennzeichnung erfolgreich erstellt!
No elements on component shape layer! = Keine Elemente auf Bauteillage
No elements on lead shape layer! = Keine Elemente auf der Lötformlage!
No pad of number 1 or A1, please modify the pad number. = Kein Pad der Nummer 1 oder A1, bitte ändern Sie die Pad-Nummer.
Save failed! Component marking circle is at the axis. Do you want to recreate the component marking? = Speichern fehlgeschlagen! Bauteilmarkierungskreis befindet sich auf der Achse. Möchten Sie die Bauteilkennzeichnung neu erstellen?
If autoroute fail, you can export the autoroute file(DSN) to third-party autorouter tool(Such as: Konekt Electra, Eremex TopoR etc.), and export the session file(SES) after finished autoroute, and then import to PCB. = Wenn Autoroute fehlschlägt, können Sie die Autoroute-Datei (DSN) in ein Autorouter-Tool eines Drittanbieters exportieren (z. B.: Konekt Electra, Eremex TopoR usw.) und anschliessend exportieren Sie die Sitzungsdatei (SES) nach beendeter Autoroute und importieren Sie sie dann auf die Leiterplatte.
Auto route failed! Found abnormal pad(s) data, please modify the pad width and height: = Autoroute fehlgeschlagen! Ungewöhnliche Pad(s)-Daten gefunden, bitte ändern Sie die Pad Breite und Höhe:
Select Properties = Eigenschaften auswählen
Combine the same parts' prefixes in one row = Kombinieren Sie die Vorsilben der gleichen Teile in einer Reihe
Please check at least one item! = Bitte wählen Sie mindestens ein Element.
Pins =
Check component latest version when open schematic =
Only show updated components =
Note: When a PCB is Import Changes, the PCB is updated according to the footprint version to which the schematic is bound. =
Doesn't support to import the binary format DXF, please import the ASCII format DXF. =

Find System Similar Footprint =
Found similar footprints at system library, it is recommended to use them first. =
Copy Title =
Check system similar footprint =
Can't find the Similar Footprint =
Search failed! =
No package information! =
Find Parameters =
Find Results =

Bill of material(BOM) uploaded finish, please click "OK" to continue. =
Bill of material(BOM) upload failed! =

All pads =
All holes =
Single layer pads =
Multi-layer pads =
Same X pads =
Same Y pads =
Same Y and clearance pads =
Same X and clearance pads =
Same X and clearance pads' clearance =
Same Y and clearance pads' clearance =
Pad's hole diameter(max) =
Pad's hole diameter(min) =
Pad's hole diameter(aver) =

Try Pro Edition =

Generate Solid Region by Objects Outline =
Generate Polygon Pad by Objects Outline =
Select the objects that cannot be generated =

Please compress schematic and PCB as a zip file and then import it, if you only import the schematic you need to binding with the footprint manually. =
Please compress schematic and PCB in ASCII format as a zip file and then import it, if you only import the schematic you need to binding with the footprint manually. =
Import failed! The imported files were not ASCII format, please save the files as "Advanced Schematic ascii(*.SchDoc)" or"PCB ASCII File(*.PcbDoc)" at Altium Designer first, and then import. =
The PCB text will use the editor new font family, the text maybe will appear a little excursion. =
Because of different file format and element, please check carefully after imported. =
Please make sure the EAGLE file is saved in EAGLE v6.0 and higher version. =
Please compress schematic and PCB as a zip file by KiCad5 and then import it, if you only import the schematic you need to binding with the footprint manually. =
Please make sure the Protel file is exported as ASCII format file. =
Please compress the schematic and corresponding symbols as a zip file and then import it. =

Please save the files as "Advanced Schematic ascii(*.SchDoc)" or"PCB ASCII File(*.PcbDoc)" at Altium Designer first, and then import. =
Tips =
Exists incomplete connection =
Found that the board has incomplete connection, please check the nets and ratlines =
creator =
You are not logged in or the login status is invalid, please login and try again. =
Display Board Cutout =
