# Menu
User = Utilisateur
Join... = Inscription...
Login... = S'identifier...
Log in = Connexion
Logout = Déconnexion
Change password... = Changer le Mot de Passe...
User Preference = Préférences Utilisateur
System Settings... = Paramètres Système...
System Settings = Paramètres Système
Crash = Plantage
Invite friends... = Inviter des amis...
Language = Langue
Language Setting = Paramètres de langue

Document Recovery = Récupération de Document
Your Preferences Information = Information sur Vos préférences
File = Fichiers
New = Nouveau
Project... = Projet...
Schematic = Schéma
Schematic-Simulation = Simulation du Schéma
Spice Symbol = Symbole Spice
Spice Subckt = Sous-circuit Spice
spicePre = spicePre
PCB = Circuit
Schematic Module = Module Schématique
PCB Module = Module PCB
Save... = Enregistrer...
Save As... = Enregistrer sous...
Save As Module... = Enregistrer comme Module...
Print = Imprimer
Export Document = Exporter document
LTspice... = LTspice...
Eagle... = Eagle...
Altium... = Altium...
Cadence... = Cadence...
Pads... = Pastilles...
DXF = DXF
Import = Importer

Edit = Editer
Undo = Défaire
Redo = Refaire
Cut = Couper
Copy = Copier
Paste = Coller
Select = Sélectionner
Delete = Supprimer
Clear All = Tout effacer
Move = Déplacer
Drag = Glisser
Bring to Front = Ammener à l'avant
Send to Back = Envoyer à l'arrière
Align = Aligner
Align Left = Aligner à Gauche
Align Right = Aligner à Droite
Align Top = Aligner en Haut
Align Bottom = Aligner en Bas
Align Horizontal Centers = Centrer horizontalement
Align Vertical Centers = Centrer verticalement
Distribute Horizontally = Répartir horizontalement
Distribute Vertically = Répartir verticalement
Distribute Left Edges Equidistantly = Répartir les bords gauches de manière équidistante
Distribute Top Edges Equidistantly = Répartir les bords du haut de manière équidistante
Align Grid = Aligner sur la grille
Rotate = Rotation
Rotate Left = Rotation vers la gauche
Rotate Right = Rotation vers la droite
Flip Horizontal = Miroir Horizontal
Flip Vertical = Miroir Vertical
Rotate and Flip = Rotation et Miroir
Group/Ungroup Symbol... = Grouper/Dégrouper les Symboles...

[menu_project]
View = Vues
[/menu_project]
Find = Trouver
Zoom In = Zoom +
Zoom Out = Zoom -
Fit in Window = Ajuster à la fenêtre
Refresh = Rafraichir
Snap = Basculer
Cross Cursor = Curseur Croisé
Toolbars = Barres d'Outils
Drawing Tools = Outils de Dessin
Wiring Tools = Outils de Cablâge
Power Objects = Organes de Puissance
PCB Tools = Outils de Circuits
Footprint Tools = Outils d'empreinte
Layers Tool = Outil de couche
Layer Manager = Gestionnaire des couches
Enable and Show All Layers = Activer et Afficher Toutes les Couches
Net Visible = Fillet Visible
Auto = Auto
Digital Objects = Objets Numériques
Tools = Outils
Arc Center = Centre de l'Arc
Arc Type = Type de l'Arc
Center Point Arc = Point Central de l'Arc
Two-point Arc = Arc à deux points

Place = Placer
Drawing Tools = Outils de Dessin
Arc = Arc
Elliptical Arc = Arc Eliptique
Ellipse = Elipse
Circle = Cercle
Pie = Tarte
Line = Ligne
Polyline = Ligne multiple
Rectangle = Rectangle
Rectangular = Rectangulaire
The rectangle does not support non-90 degree rotation. Please use Solid Region instead. = Le rectangle de supporte pas les roation hors 90 degrés. Utilisez une Région Solide à la place.

Rect = Rect
Round Rectangle = Rectangle arrondi
Polygon = Polygone
Bezier = Bézier
Path = Chemin
Graphic = Grapique
Bus = Bus
Bus Entry = Entrée de Bus
Junction = Jonction
Net Port = Port de Liaison
Voltage Probe = Sonde tension
Power Port = Port de Puissance
Wire = Connexion
Annotation = Annotation
Track = Piste
Image = Image
Arrow Head = Flêche d'entête
Arrowhead = Bout de flêche
Arrow = Flêche
No Connect Flag = Balise sans connexion
Place = Placer
Pin = Broche
Lock Selected Objects = Vérouiller les Objets Séléctionnés

Miscellaneous = Divers
Find Component = Chercher Composant
Component = Composant
Footprint... = Empreinte...
This component is deleted! = Ce composant est supprimé !
Convert = Convertir
Convert Schematic to PCB = Convertir le Schéma en PCB
The component ID will be reset according to the component prefix, this operation will clear Undo histories. Please notice: = L'ID du composant sera réinitialiser selon ses préfixs, cette opération videra l'historique des Annulations. Veillez noter:
Please make sure the component prefixes of the schematic and PCB are corresponding = Assurez-vous que les préfixes du composant du Schéma et du PCB correspondent
Please reset the component ID of corresponding schematic or corresponding PCB too = Veillez aussi réinitialiser l'ID des schémas ou PCB correspondant
Do you want to continue? = Voulez-vous continuer ?
Reset Component ID = Réinitialiser l'ID du composant
Component ID reset successfully! = L'ID du composant réinitialisé !
Convert to PCB = Convertir en PCB
Update PCB = Mettre à jour le PCB
Shortcut Keys Setting = Paramétrage des raccourcis clavier
Edit Symbol... = Edition de Symbole...
Highlight Net... = Piste en surbrillance...
Simulate = Simuler
Simulation = Simulation
Standard Mode = Mode Standard
Simulation Mode = Mode Simulation
Change to Standard Mode = Changer vers le Mode Standard
Change to Simulation Mode = Changer vers le Mode Simulation
Welcome to Use LCEDA = Bienvenue dans l'utilisation de LCEDA
Welcome to Use EasyEDA = Bienvenue dans l'utilisation de EasyEDA
Enable Education Edition Features for Free >>> = Activez gratuitement les fonctionnalités de l'édition Éducation >>>
Quick Start = Démarrage rapide
More Help = Plus d'aide
Explore = Explorer
Message = Message
[start]
Example = Exemple
Forum = Forum
Tutorials = Tutoriels
Videos = Vidéos
[/start]
Custom Data = Données personnalisées
LCEDA = LCEDA

Copy Result Image = Copier les résultats de l'Image
Export Result Image = Exporter les résultats de l'Image
Simulation Result = Résultats de la Simulation
Simulation Results... = Résultats de simulation...
Simulate this Sheet = Simuler cette Feuille
Simulate this Project = Simuler ce Projet
Non-simulation mode, please switch to the simulation mode first and then run = Mode hors-simulation, merci de passer en mode Simulation puis de réessayer.
Run the Document = Exécuter le Document
Run the Project... = Exécuter le Projet...
Netlist for Document = NetList du Document
Netlist for Project = NetList du Projet
LTspice for This Sheet... = LTspice pour cette Feuille...
Spice for this Project... = Spice pour ce Projet...
Protel/Altium for PCB... = Protel/Altium pour Circuit...
PADS for PCB... = PADS pour PCB...
FreePCB for PCB... = FreePCB pour Circuit...
Eagle for PCB... = Eagle pour Circuit...
Kicad for PCB... = Kicad pour Circuit...
OrCAD for PCB... = OrCAD pour Circuit...
BOM report... = Rapport de Nommenclature...
BOM for Document... = Nommenclature du Document...
BOM for Project... = Nommenclature du Projet...
Pin Manager... = Gestionnaire de broches...
Spice Model... = Modèle Spice...
Layer Manager... = Gestionnaire des couches...
Net Color... = Couleur du quadrillage...
Design Rule... = règle de dessin
Copper Area = Zone de cuivre
Rebuild Selected = Réactualiser la selection
Rebuild All = Réactuliser la totalité
Copper Area Manager... = Réglage de la zone de cuivre
Export Pick and Place File = Exporté et placé le fichier
Measure Distance = Mesurer une distance
Set Canvas Origin by Mouse Location = Remettre le curseur à l'origine
Generates Pick and Place File = Génère le fichier de placement
Unroute All = Annulé le routage
Auto Route = Routage automatique
Export Autorouter File(DSN) = Exporter le fichier routage
Import Autorouter Session File(SES) = importer une session de routage
Autorouter File(DSN) = Routage automatique du fichier
Autorouter Session File(SES) = Routage de la session
Terminate Routing Automatically = Terminer le routage automatiquement
Delete Segments = Effacer le segment
Unroute Connections = Supprimer les routages
Unroute Connection = Supprimer le routage
Unroute Nets = Annuler routage Nets
Select = Sélectionner
Segments = segments
Connection = connexion
Net = Connexion interne
Apply Design Rule While Routing and Auto Placing Via = Appliquer les règles de routage et placer les vias automatiquement

Add SubPart = Ajoute une sous-partie
Annotate... = Annoter...
Config = Configurer

Help = Aide
About = A Propos de
Shortcut Keys = raccourcies
FAQ = Questions fréquentes
Tutorials = Tutorial
Basic Tutorials = Tutoriaux basic
Video Tutorials = Tutoriaux vidèo
Essential Check = Vérification essentiel
Simulation Tutorials = Simuler les tutoriaux
Updated Instructions = Mise à jour des instructions
Open File Format = Ouvrir un fichier
About Upgrade = A propos des mise à jour
User Forum = Forum utilisateur
Feature Request = Requète utilisateur
Feature Requests = Requètes utilisateur
Bug Report = Rapport de bug
Bug Reports =Rapports de bug
Tips & Skill = Conseils et compétences
Ask for Help = Demander pour de l'aide
Schematic Capture = Capture du schéma
Spice Simulation = Simulation
Non-simulation mode = Mode sans simulation
PCB Layout = couche du circuit imprimé
General Discussion = Discution générale
More Information = Plus d'information
Privacy Policy = Règles privées
#Terms of Use & Privacy Policy = Termes d'utilisation
Terms of Service = Termes du service
Plans and Pricing = Plans et prix
Help Translate = Aider à la translation
About Us = A propos de nous
Contact Us = Nous contacter
Change History = Modifier l'historique
Join Us = Nous rejoindre
#PCB Fabrication Capabilities
PCB Fabrication = Fabrcation du circuit imprimé
Order Capabilities = Capacité de fabrication
Order Price = Prix de la commande
Order Essential Check = Vérifier l'essentiel de la commande
Order FAQ = Questions sur la commande
Order Process = Etat de la commande
Full Screen = Plein écran

Support = Support
[leftNavTabs]
Support = Support
[/leftNavTabs]
Historical Records... = Enregistrements de l'historique
Extensions = Extensions
Order PCB... = Commander des circuits...
Import Changes = Importer les changements
Press {0}F11{1} to switch to full screen. = Appuyer sur{0} F11{1} pour mettre en plein écran
Delete Selected = Supprilmer la sélection
Simulate... = Simulation...
Config = Configurer
Terms of Service & Privacy Policy = Conditions d'utilisatioons & Politique de Vie privée
Help Topics = Sujets de l'aide
3D Model(obj) = Modèle 3D(obj)
3D Model(step) = Modèle 3D(step)
SVG Source... = Source SVG...
File Source = Fichier source
Group These Items as a Symbol = Regrouper ces éléments en un symbole
Group These Items as a Footprint = Regrouper ces éléments en une empreinte
Set Canvas Origin = Définir l'origine du canvas
Document Setting = Réglage du document
Sheet Properties = Propriété de la feuille
Set Board Outline = Définir les bords du circuit
Teardrop... = Teardrop...
Panelize... = Taille du panneau...
Check Dimension = Vérifier Dimension
Smart Dimension = Dimension rapide
Footprint Wizard = Assistant d'empreintes
Footprint Wizard... = Assistant d'empreintes...
Select package type = Séléctionner le type de paquet
Smart Dimension Properties = Propriétés de dimensions intelligentes
Global Delete = Suppression globale
Cross Probe = 
Cross Probe and Place =
Paper Size = Taille du papier
Register = Enregistrer
User Center =

By Mouse Location = Par l'emplacement de la souris
Set Coordinate = Determiné les coordonées
By Coordinates... = Par coordonnées
By Center of Pads = Du centre des pads
By Center Grid of Symbols = 

#Schematic Canvas Properties
Properties = Propriétés
Apply = Appliquer
Save as default = Enregistrer comme valeurs par défaut
Canvas Properties = Attibuts des fils aériens
Width = Largeur
Height = Hauteur
Background = Arrière-plan
Visible Grid = Grille Visible
Grid Visible = Grille Visible
Real-Time Track Length = Longeur de la piste en temps réel
Display Real-Time Track Length = Afficher la longeur de la piste en temps réel
Grid Color = Couleur de Grille
Grid Size = Taille de Grille
Grid Style = Style de Grille
Grid.Line Width = Grille.Largeur de ligne
Grid.Line Spacing = Grille.Espacement des lignes
Copper to Board Outline = Cuivre jusqu'au contour
Improve Fabrication = Améliorer la fabrication
Spoke Width = Largeur des rayons
Stroke Color = Couleur du trait
Stroke Width = Largeur du trait
Stroke Style = Style du trait
Fill Color = Couleur de remplissage
Selected Objects = Objets sélectionnés
Frame Size = Taille du cadre
Alt Snap =
Snap size when pressing the Alt key = 
Prefix Start = 

#Text Properties
Text Properties = Attributs du texte
Text = Texte
Color = Couleur
Font Family = Famille de la police
Font Size = Taille de la police
Font Weight = Poids de la police
Font Style = Style de la police
Text Type = Type de texte
Text Anchor = Ancre du texte
Baseline = Ligne de base
(Auto) = (Automatique)
(auto) = (automatique)
start = Début
middle = Milieu
end = Fin
inherit = hériter
comment = Commenté
spice = spice
normal = Nomale
italic = Italique
Default = Défaut
Add = Ajouter
bold = Gras
bolder = plus gras
lighter = plus fin
Failed to parse the font file: {name} = Échec de l'analyse du fichier de police : {name}
Please select a font file of ttf or woff format. = Veuillez sélectionner un fichier de police au format ttf ou woff.
Add font success: {name} = Ajout de la police réussi: {name}
Failed to add font: {name} = Echec de l'ajout de la police: {name}
Add Font = Ajouter police
Failed to parse cached font: {name} = Échec de l'analyse de la police en cache : {name}
Load cached fonts fail! = Échec du chargement des polices en cache !

#Stroke
Stroke Color = Couleur du trait
Stroke Width = Largeur du trait
Stroke Style = Style du trait
Fill Color = Couleur de remplissage
X Radius = Rayon de X
Y Radius = Rayon de Y

#spice
Switch mode = Changer de mode
The current documents will be closed, and reopen after switching mode, do you want to continue? = Les documents actuels seront fermés, et rouverts après le changement de mode, voulez-vous continuer ?
PCB related documents are not allowed in emulation mode = Les documents relatifs aux PCB ne sont pas autorisés en mode émulation.
Please change the editor to "Simulation" mode first at the top left corner. = Veuillez changer l'éditeur en mode "Simulation" d'abord dans le coin en haut à gauche
Please change the editor to "Standard" mode first at the top left corner. = Veuillez changer l'éditeur en mode "Standard" d'abord dans le coin en haut à gauche
Common = Commun
spice.open = spice.ouvert
spice.close = spice.fermé
Sources = Sources
Instruments/Meters = Instruments/mètres
Transistors = Transistors
Digital Circuits = Circuits numériques
Operational Amplifier = Amplificateur opérationnel
multimeter = Multimètre
multimeter Settings = Paramètres du multimètre
FunctionGenerator Settings = Paramêtre du générateur de fonction
Voltage Source Settings = Paramètres de la source de tension
Current Source Settings = Paramètres de la source de courant
Powersw Settings =
Resistor Settings = Paramètres de la résistance
Capacitor Settings = Paramètres du condensateur
Diode Settings = Paramètres de la diode
voltPowersw Settings =
Inductor Settings = Paramètres de l'inductance
VCVS Settings = Paramètres de VCVS
CCCS Settings = Paramètres de CCCS
VCCS Settings = Paramètres de VCCS
CCVS Settings = Paramètres de CCVS
JFET Settings = Paramètres de JFET
FET Settings = Paramètres du FET
Transmission Line Settings = Paramètres de la ligne de transmission
Oscilloscope Settings = Paramètres de l'oscilloscope
XFMR Settings = Paramètres de XFMR
LOGIC Settings = Paramètres de LOGIC
LOGICSTATE Settings = Paramètres de LOGICSTATE
DIGITALCLOCK Settings = Paramètres de DIGITALCLOCK
Potentiometer Settings = Paramètres du potentiomètre
MUTUAL_INDUCTORS Settings = Paramètres des MUTUAL_INDUCTORS
NE555 Settings = Paramètres du NE555
THREE_PHASE Settings = Paramètres du Paramètres du
Logic_Probe Settings = Paramètres des sondes logiques
78XX Settings = Paramètres du 
79XX Settings = Paramètres du 
OPAMP5PEE Settings = Paramètres de OPAMP5PEE
OPAMP5PEECN Settings = Paramètres de OPAMP5PEECN
OPAMP3PEE Settings = Paramètres de OPAMP3PEE 
OPAMP3PEECN Settings = Paramètres de OPAMP3PEECN
DELAY_FUSE Settings = Paramètres du fusible retardé
Ratio = Ratio
K[%] = K[%]
Model = Modèle
States = États
Voltage[V] = Tension[V]
Voltage gain[V/V] = Gain en tension[V/V]
Current gain[A/A] = Gain en courant[A/A]
Transconductance[Mho] = Transconductance [Mho]
Transresistance[Ω] = Transresistance[Ω]
Voltage Source Type = Type de source de tension
Current Source Type = Type de source de courant
multimeter type = type de multimètre
power type = type d'alimentation
Voltmeter Resistance(R)(Ω) = Résistance du voltmètre(R)(Ω)
Amperometer Resistance(R)(Ω) = Résistance de l'ampermètre(R)(Ω)
mu.V =
mu.A =
Sine Wave = Signal sinusoidal
Triangular Wave = Signal triangulaire
Rectangular Wave = Signal rectangulaire
AC = Alernatif
DC = Continu
SINE = Sinus
PULSE = Impultion
EXP = 
SFFM =
PWL =
B.spice =
DC Value[V] = Valeur CC[V]
DC Value[A] = Valeur CC[A]
DC offset[V] = Décalage CC[V]
DC offset[A] = Décalage CC[A]
Amplitude[V] = Amplitude[V]
Amplitude[A] = Amplitude[A]
Freq[Hz] = Frequence[Hz]
Theta[1/s] = Théta[1/s]
Tdelay[s] = Tdelai[s]
Phi[deg] = Phi[deg]
Tperiod[s] = Tperiode[s]
Ton[s] = 
Tfall[s] = 
Trise[s] = 
Von[V] = 
Von[A] = 
Vinitial[V] = 
Vinitial[A] = 
Vpulsed[V] = 
Vpulsed[A] = 
Rise Delay[s] = 
Rise Tau[s] = 
Fall Delay[s] = 
Fall Tau[s] = 
Carrier Freq[Hz] = Fréquence Porteuse[Hz]
Modulation Index = Taux de modulation
Signal Freq[Hz] = Fréquence du signal[Hz]
Time[s] = Temps[s]
Value[V] = Valeur[V]
Value[A] = Valeur[A]
Waveforms = Forme du signal
Duty cycle[%] = Rapport cyclique
Amplitude[Vp] = Amplitude[Vp]
Offset[V] = Décalage[V]
Rise/Fall Time[sec] = Temps de monté/descente[sec]
Capacitance[F] = Capacité[F]
sComponent =
Inductance[H] = Inductance[H]
Gbw =
Slewrate =
Avol =
Rout(Ω) = R_sortie(Ω)
Rin(Ω) = R_entrée(Ω)
Ibias[A]
Inhi[V]
Inlo[V]
Isc[A]
Outhi[V]
Outlo[V]
Vabsmax[V]
Vmin[V]
Iq[A]
Cin[F]
high = Haut
low = Bas
Oscilloscope = Oscilloscope
Logic Analyzer = Analiseur Logique
Channel_A = Canal_A
Channel_B = Canal_B
Channel A = Canal A
Channel B = Canal B
Time = Temps
Reverse = Inverser
Simulation file exceed = Dépassement du fichier de simulation
The simulation file is too large and has been stopped for performance reasons. = Le fichier de simulation est trop volumineux et a été arrêté pour des raisons de performance.
Timebase = Base de temps
Scale: = Echele
X pos.(Div): =
Y pos.(Div): =
View meter... =
The circuit has components without simulation model: = Le circuit comporte des composants sans modèle de simulation :
Your simulation interval is too short to simulate, please wait 5 seconds later and try again; if still show this message, may be you simulated over 500 times the maximum simulation times per day. = Votre intervalle de simulation est trop court, veuillez attendre 5 secondes plus tard et réessayer ; si ce message s'affiche toujours, il se peut que vous ayez simulé plus de 500 fois, le nombre maximal de simulations par jour.
Resistor1_US = Résistance1_US
Resistor1_EU/IEC = Résistance1_EU/IEC
Resistor1_3D = Résistance1_3D
Capacitor1_US = Condensateur1_US
Capacitor1_EU/IEC = Condensateur1_EU/IEC
Capacitor1_3D = Condensateur1_3D
Rheostat_US = Rhéostat_US
Rheostat_EU/IEC = Rhéostat_EU/IEC
Rheostat_3D = Rhéostat_3D
Capacitor_Electrolytic_US = Condensateur_électrolytique_US
Capacitor_Electrolytic_EU/IEC = Condensateur_électrolytique_EU/IEC
Capacitor_Electrolytic_3D = Condensateur_électrolytique_3D
Inductor_US = Inductance_US
Inductor_EU/IEC = Inductance_EU/IEC
Inductor_3D = Inductance_3D
Resistor2_US = Résistance2_US
Resistor2_EU/IEC = Résistance2_EU/IEC
Resistor2_3D = Résistance2_3D
Multimeter = Multimètre
Multimeter_3D = Multimètre_3D
Oscilloscope = Oscilloscope
Oscilloscope_3D = Oscilloscope_3D
Signal_Generator = Générateur_de_signaux
Signal Generator_3D = Générateur_de_signaux_3D
Wattmeter = Wattmètre
Wattmeter_3D = Wattmètre_3D
NSSWS1080T_3D =
Voltage_Source_VDC = Source_de_tension_VSin
Voltage_Source_VSin = Source_de_tension_VDC
Voltage_Source_VPULSE = Source_de_tension_VPULSE
Voltage_Source_VEXP = Source_de_tension_VEXP
Voltage_Source_VSFFM = Source_de_tension_VSFFM
Voltage_Source_VPWL = Source_de_tension_VPWL
Voltage_Source_V_Behavioral_Source =
Current_Source_IDC = Source_de_courant_IDC
Current_Source_ISin = Source_de_courant_ISin
Current_Source_IPULSE = Source_de_courant_IPULSE
Current_Source_IEXP = Source_de_courant_IEXP
Current_Source_ISFFM = Source_de_courant_ISFFM
Current_Source_IPWL = Source_de_courant_IPWL
Current_Source_I_Behavioral_Source =
CCCS_1 =
CCCS_2 =
CCVS_1 =
CCVS_2 =
VCCS =
VCVS =
Three_Phase_Wye_Load =
Three_Phase_Delta_Load =
78XX = 78XX
79XX = 79XX
555 = NE555
555_3D =
Transformer_US = Transformateur_US
Transformer_EU/IEC = Transformateur_EU/IEC
Transformer_Center_Tapped_US =
Transformer_Center_Tapped_EU/IEC =
Mutual_Inductor_US = Inductance_mutuelle_US
Mutual_Inductor_EU/IEC = Inductance_mutuelle_EU/IEC
Mutual_Inductor2_US = Inductance_mutuelle2_US
Mutual_Inductor2_EU/IEC = Inductance_mutuelle2_EU/IEC
OR2EE_US =
OR3EE_US =
OR4EE_US =
OR2EE_CN =
OR3EE_CN =
OR4EE_CN =
NOR2EE_US =
NOR3EE_US =
NOR4EE_US =
NOR2EE_CN =
NOR3EE_CN =
NOR4EE_CN =
AND2EE_US =
AND3EE_US =
AND4EE_US =
AND2EE_CN =
AND3EE_CN =
AND4EE_CN =
NAND2EE_US =
NAND3EE_US =
NAND4EE_US =
NAND2EE_CN =
NAND3EE_CN =
NAND4EE_CN =
XOR2EE_US =
XOR2EE_CN =
XNOR2EE_US =
XNOR2EE_CN =
Digital_Clock_1Hz =
Logicstate_0 = Etat_logique_0
Logicstate_1 = Etat_logique_1
Logic_Probe = Sonde_logique
Buffee =
INVEE_US =
INVEE_CN =
Schmittbuffee =
LM358N_US =
LM358N_CN =
OPAMP3PEE_US =
OPAMP3PEE_CN =
OPAMP5PEE_US =
OPAMP5PEE_CN =
Voltage_Controlled_Switch =
Current_Controlled_Switch =
FUSE = FUSIBLE
Delay_Fuse = Fusible retardé
Transmission_Line = Ligne_de_transmission
Crystal =
DFFEE =
TFFEE =
JKFFEE =
SRFFEE =
SRLATCHEE =
SRNANDFFEE =
SRNORFFEE =
INVTSEE =
INVODEE =
Schmittbuffee =
Cbuffer =
SPDT_Open =
SPDT_Close =
SPST_Close =
SPST_Open =
Fast_Crystal =
Lamp =
BCD_Segment =
Seven_Segment = 
Traffic_Light =
Lamp Settings =
Power[W] = Puissance[W]
Dropout Voltage[V]
Current[A]
Threshold[V]
Clock Rate = 
TrafficLight Settings =
BCDSegment Settings =
SevenSegment Settings =
SPDT Settings =
SPST Settings =
LogicAnalyzer Settings = Paramètres de l'analyseur logique
Fuse Settings = Paramètres du fusible
Wattmeter Settings = Paramètres du Wattmètre
open = ouvert
close = fermé
Common Anode = Anode commune
Common Cathode = Cathode commune
AC Amplitude = Amplitude AC
AC Phase = Phase AC
There are some parts haven't spice model, please use "EElib" and "Spice Symbol" at "Libraries" of "Simulation" mode, or you can assign the spice model for them: = Certains composants n'ont pas de modèle spice, veuillez utiliser "EElib" et "Spice Symbol" dans "Librairies" du mode "Simulation", ou vous pouvez leur attribuer directement le modèle spice :

#Pin
Pin Properties = Attributs de la broche
Orientation = Orientation
Line 45° = Ligne à 45°
Line 90° = Ligne à 90°
Arc 45° = Arc à 45°
Arc 90° = Arc à 90°
Free Angle = 
Start X = Début X
Start Y = Début Y
Length = Longueur
Name = Nom
name = Nom
Number = Nombre
Spice Pin Order = 
Display Number = Numéro d'affichage
Clock = Horloge
Show = Montrer
Electric = Électrique

#Junction
Junction Properties = Attibuts de la jonction
X Location = Emplacement X
Y Location = Emplacement Y
Size = Taille
Color = Couleur

#Net Label
Net Label = Etiquette de la connexion

#Part
Prefix = Prefixe

#Image Properties and Dialog
Add Image = Ajouter une image
Image Properties = Attibuts de l'image
Image URL = URL de l'image
Input an image URL = Entrer l'URL d'une image
Invalid image URL = URL de l'image invalide
Invalid Prefix = Préfixe invalide
Failed to load the image = Echec du chargement de l'image
Image URL contains special characters = L'URL de l'image contient des caractères spéciales
From Web URL = Depuis une URL sur le Web
From Local Computer = Depuis un ficier de l'oridinateur
Please select a png/gif/jpg file. = Veuillez séléctionner un fichier de type png/gif/jpg.
Please select an image file. = Veuillez séléctionner un fichier image
Select an image file = Sélectionner un fichier image
Insert Image to PCB = Insérer une image sur le PCB
Tolerance = Tolérance
tolerance = tolérance
capacitance = capacité
frequency = Fréquence
Rated Voltage = Tension nominale
Rated Current = Courant nominal
resistance = Résistance
Resistance = Résistance
Resistance[Ω] =Résistance[Ω]
inductance = inductance
Operating Temperature = Température de fonctionnement
Shape Invert = Inversion de forme
Image Size = Taille de l'image
Color Tolerance = Tolérance de couleur
Simplify Level = Simplifier le niveau
Corner Threshold = Seuil d'angle

#PCB Canvas Properties
Units = Unités
Snap Size = Taille du contact
Other = Autre
Routing Width = Largeur de routage
[router]
Routing Width = Largeur de routage
[/router]
Please using hotkey {0}{key1}{1} or {2}{key2}{3} to change track width while on routing. =
Routing Angle = Angle de routage
Routing Conflict = Conflit de routage
Remove Loop = Retirer la boucle
Cut SilkScreen = Retirer la sérigraphie
Grid = Grille
Grid 90 =
Grid 45 =
Copper Zone = Zone de cuivre
Visible = Visible
Invisible = Invisible
Ignore = Ignorer
Block =
RoundTrack =

#Track
Track Properties = Propriétés des pistes
Layer = Couche
Net = Connexion
Start X = Début X
Start Y = Début Y
End X = Fin X
End Y = Fin Y
ID = Repère

#Pad Properties
Pad Properties = Propriétés des pastilles
Shape = Forme
Hole(D) = Perçage (Diamètre)
Center X = Centre X
Center Y = Centre Y
Round = Cerculaire
Oval = Ovale
Hole Shape = Forme du trou
Slot = Fente
Hole(Length) = Trou(Taille)
Plated = Plaqué
None = Aucun
Paste Mask Expansion = Elargissement du masque de la pate à souder 
Solder Mask Expansion = Elargissement du masque de soudure

#Via Properties
Via Properties = Propriétés du via
Diameter = Diamètre
Drill Diameter = Diamètre du foret

#Hole Properties
Hole Properties = Propriétés du trou


#TEXT
Text Properties = Propriétés du texte
Line Width = Largeur de la ligne
Rotation = Rotation
Fonts Management = Gestion des polices

#Dimension Properties
Dimension Properties = Attributs des dimensions

#Footprint Properties
Component Properties = Propriétés du composant
Display Prefix = Préfixe d'affichage
Pin Name = Nom de la broche
Pin Number = Numéro de la broche
Spice Pin Number = Numéro de la broche Spice
Graphics =
Pattern =

#Arc Properties
Arc Properties = Propriétés des arcs de cercles
Start Angle = Angle de débart
End Angle = Angle de fin
Rotation Direction = Sens de rotation

#Rect Properties
Rect Properties = Propriétés des rectangles
Round radius = Rayon de l'arrondi

#Circle Properties
Circle Properties = Propriétés des cercles
Radius = Rayon

#CopperArea Properties
CopperArea Properties = Propriétés des zones de cuivre
Clearance = espacement
Pad Connection = connection aux pastilles
Direct = Directe
Spoke = Rayon
Keep Island = Conserver les zones orphelines
Fill Style = Style de remplissage
CopperArea conflict: copper area outlines in same layer with different net names must not overlap = Conflit de zones de cuivre : les différentes zones de cuivre d'une même couche ne peuvent pas se superposer.
Copper area rebuild complete! You can set "Copper Zone" as "Visible" at the right-hand property panel after single click the empty area. = La reconstruction de la zone cuivre est terminée ! Vous pouvez définir la "Zone de cuivre" comme "Visible" dans le panneau de propriétés de droite après avoir cliqué sur la zone vide. 
Please create board outline first. = Veuillez d'abord créer le contour de la carte. 
Board outlines are not closed. = le contour n'est pas fermé.
Rebuild CopperArea = Reconstruire les zones de cuivre
Edit Points = Modifier les points
Direct = Directe
Spoke = Rayon
No Solid =
Board Cutout = Découpe de la carte
Solid = Solide
[copperArea]
None = Aucun
[/copperArea]

#Custom Properties
Custom Properties = Attributs personnalisés
Fixed Properties =
Add new parameter = Ajouter un nouveau paramètre
Add New Parameter = Ajouter un nouveau paramètre
Add New Supplier = Ajouter un nouveau fournisseur
Mounted = Monté
Unknown = Inconnue

Custom = Personnalisé
Scan the QR code below and open it on the mobile side = Scannez le code QR ci-dessous et ouvrez-le sur mobile =.
How to create a single layer PCB = Comment créer un PCB à une seule couche
Currently doesn't support layout single layer directly, please refer at: =

#Dialog Register
Create an account = Créer un Compte
Username = Nom d'utilisateur
Password = Mot de passe
Confirm Password = Confirmer le mot de passe
Email = Adresse Email
Please read this before you register = Lisez avant de vous inscrire
Hi {username} = Bienvenue {username}

#Dialog lostPassword
Lost Password... = Mot de passe oublié...
Find the password using your email = Récupérer le mot de passe avec l'adresse mail



#Dialog Login
Login = S'identifier
Username or Email = Nom d'utilisateur ou adresse Email
Remember Me = Se souvenir de moi
Third party = Tiers
Login and Register = Se connecter et s'inscrire
Your login information seems expired, please login again. Don't need to close the opening files, you can continue to save them after login. = Votre session semble expirée, veuillez vous connecter de nouveau. Il n'est pas nécessaire de fermer les fichiers ouverts, vous pourrez continuer de les sauvegarder après la connexion.

#Dialog Reset Password
Reset a password using your email = Réinitialisez votre mot de passe avec votre adresse email
Your registered email = Votre email enregistré

#Dialog Reaction
Re-send an activation code to your email = Réenvoyer un code d'activation à votre adresse email

#Dialog Invite
Invite friends to register = Inviter des amis à s'enregistrer
Your friend's email = L'email de votre ami

#Dialog Add A New Parameter
Add a new parameter = Ajouter un nouveau paramètre
Key = Clé
Value.new_para =
In BOM = Dans la nomenclature
Add into BOM = Ajouter à la nomenclature
Invalid key = Clé invalide
This field is required. = Ce champ est obligatoire

#Dialog Change Your Password
Change your password = Changer votre mot de passe
Old password = Ancien mot de passe
New Password = Nouveau mot de passe
Confirm Password = Confirmer le mot de passe

#Dialog Create New Design
Save as a New Project = Enregistrer en tant que Nouveau Projet
Save as a schematic = Enregistrer comme Schéma
Save as Symbol = Enregistrer comme symbole
Save as a spice Symbol = Enregistrer comme symbole Spice
Save as a spice subckt = Enregistrer comme sous-circuit Spice
YOU MUST CREATE A SPICE SYMBOL WITH EXACTLY THE SAME NAME AS THIS SUBCKT = VOUS DEVEZ CREER UN SYMBOLE SPICE AVEC EXCATEMENT E MEME NOM QUE CE SOUS-CIRCUIT
Save as a PCB file = Enregistrer comme Fichier de Circuit
Save as Footprint = Enregistrer en tant qu'empreinte
Save as a Schematic Module = Enregistrer en tant que module d'un schéma
Save as a PCB Module =  Enregistrer en tant que module d'un PCB
Save as 3D Model = Enregistrer en tant que modèle 3D
Save as a WaveForm =
Title = Titre
Share = Partager
Add file = Ajouter un fichier
Visibility = Visibilité
Allow Comments = Autoriser les commentaires
Public (Anyone can see this project but only you can modify it.) = Publique (Vous seul pouvez modifier le Projet. Tout le monde peut le consulter.)
Private (Only you can see and modify this project) = Privé (Vous seul pouvez modifier ou afficher le Projet.)
Create new project success! = Création d'un nouveau project réussite!
You can now create files under this project = Vous pouvez maintenant créer des fichiers sous ce projet
This file must be saved under a project, choose other project or create a new project = Ce fichier doit être sauvegardé sous un projet, choisissez un autre projet ou créez un nouveau projet 
Please login to save this kind of document = Veuillez vous connecter pour sauvegarder ce genre de document
Duplicated project title = Titre du project dupliqué
#Duplicated document title
Project does not exist = Ce project n'existe pas
Document does not exist = Ce document n'existe pas
document not exists = document non existant

Categories = Catégories
Project = Projet
Short description = Courte description
Content = Contenue
Modify this project info. = Modifier les informations du Projet
Modify this file info. = Modifier les informations du Document
Notice =
Search for it before creating a new one. = Trouver avant de créer.
Manufacturer Part Number = Numéro de pièce du fabricant
Supplier = Distributeur
Or =
Supplier Part = Pièce du distributeur
Supplier Part Number = Numéro de pièce du distributeur
Link = Lien
link = lien
The professional function please refer at: = Pour la fonction professionnelle, veuillez vous référer à : 

#Dialog Clone My Part
#Clone it to a project
#Clone it, then edit it
Clone your file = Dupliquer ce fichier

#Dialog Subckt
Attach a Subckt to this spice symbol = Lier un sous-circuit à un Symbole Spice
Subckt string =
Spice symbol title just allow [0-9][a-z][A-Z] and _

#Design Manager
Design Manager = Gestionnaire de Projets
Nets =
DRC Errors =
Are you sure you want to unroute this net? = Êtes-vous sûr de vouloir dérouter ce réseau?
Unroute = Dérouter
Track Length = Longueur de la piste
Via/Hole Outer Size =
Filter nets =
Design Rule Checking = Vérification des règles de conception
Board Outline = Countour de la carte
Plane Zone =
[drcRule]
Width = Largeur
DRC Width =
Length = Longueur
DRC Length =
Drill Diameter = Diamètre du foret
DRC Drill Diameter =
Diameter = Diamètre
DRC Diameter =
Object =
DRC Clearance =
[/drcRule]
#It will take a while to unroute this net, do you want to continue?
More than one netlabel is found in wire, please checked whether this is correct, if you design it on purpose, please ignore this warning. = Plus d'un netlabel est trouvé dans le fil, veuillez vérifier si c'est correct. Si c'est voulu, veuillez ignorer cet avertissement.
Incomplete net, a complete net should contain two or more pins, if you design it on purpose, please ignore this warning. = Net incomplet, un net complet doit contenir deux broches ou plus, si c'est voulu, veuillez ignorer cet avertissement.
This netlabel is not connected with any pin. = Ce netlabel n'est connecté à aucune broche.
Incomplete connection, please check. = Connexion incomplète, veuillez vérifier.
The clearance between two objects is less than the Design Rule Checking (DRC) clearance which has different nets. = L'espace libre entre deux objets est inférieur à l'espace libre de la vérification des règles de conception (Design Rule Checking, DRC), qui comporte différents nets.
The diameter is less than Design Rule Checking (DRC) diameter =
The drill diameter is less than Design Rule Checking (DRC) drill diameter =
The track length is longer than Design Rule Checking (DRC) track length =
The track width is less than Design Rule Checking (DRC) track width =

#Dialog Simulation
Show your simulation report = Afficher le rapport de simulation
Download netlist = Télécharger la NetList
Run = Démarrer
Components = Composants

#Dialog Import
Import file from your computer = Importer un fichier à partir de votre ordinateur
Maximum file size: 30 MB = Taille maximum du fichier: 30 Mo
Maximum file size: 100 MB = Taille maximum du fichier: 100 Mo
Chose file = Choisir un fichier
File Operation = Opération sur le fichier
Import File = Importer le fichier
Extract Libs = Êxtraire les Librairies
Import File and Extract Libs = Importer un fichier et extraire les librairies
File type = Type de fichier
The file size is too large. = La taille du fichier est trop grande.
Please selected the file type. = Veuillez sélectionner le type de fichier.
No component was found! = Aucun composant n'a été trouvé!
Import successfully = Importation réussie!
Import failed = Importation échoué
Click OK to continue with the import = Appuyez sur OK pour continuer l'importation
Select None = Sélectionnez Aucun

#Dialog Modify Symbol Information
Modify symbol information = Modifier les informations du symbole
Spice Prefix = Préfixe Spice
Hide Pin = Cacher broche
Pin Manager = Gestionnaire des broches
When a power pin is hidden, it will be marked as netlabel, you don't need to wire it. If you use it as simulation, please show it or create a GND/VCC Net for it. = Quand une broche d'alimentation est cachée, elle sera marquée comme netlabel, vous n'avez pas besoin de la câbler. Si vous l'utilisez comme simulation, veuillez la montrer ou créer un net GND/VCC pour elle.
Assign = Assigner
Supplier.bom = Distributeur.BOM
LCSC.bom = LCSC.bom
Price = Prix
Quantity.bom = Quantité.bom
Package.bom = Boitier.bom
Components.bom = Composants.bom
Manufacturer Part.bom = Pièce du fabricant.bom
Manufacturer.bom =fabricant.bom

One-click Purchasing at LCSC = Achat en un clic sur LCSC
Order Parts = Commander des composants 
Export BOM = Exporter la nommencature
Export PCB BOM = Exporter la nommencature PCB
Export Schematic BOM = Exporter la nommencature du schéma
ID.bom =
Name.bom = Nom.bom
[bom]
Name = Nom
LCSC Assembly = Assemblage LCSC
Value = Valeur
ID = Repère
Supplier = Distributeur
LCSC = LCSC
Price = Prix
Quantity = Quantité
Package = Boitier
Components = Composants
Manufacturer = Fabricant
[/bom]
Manufacturer Part = Pièce du fabricant

#Dialog Run
Run your simulation = Lancer la Simulation
Transient = Transitoires
Maximum Timestep =
Stop Time = Temps de départ
Start Time = Temps d'arrivée

AC Analysis = Analyse AC
Type of Sweep =
Number of points =
Start Frequency = Fréquence de départ
Stop Frequency = Fréquence d'arrivée

DC sweep = Modulation DC
Source to Sweep =
Start Value = Valeur de départ
Stop Value = Valeur d'arrivée
Increment = 
DC Transfer = Transfert DC :
Output = Sortie
Source = Source

DC op pnt =
Compute the DC operating point treating capacitances as opens and inductances as shorts = Calculer le point de onctionnement DC en traitant les condensateurs comme des circuits ouverts et les bobines comme des circuits fermés

#Dialog Share Info
Active File = Fichier actif
Active Project = Projet actif
Readonly = Lecture seule
Editable = Modifiable
Active file's owner project page = Page du projet du propriétaire du dossier actif
Active project editor page = Page active de l'éditeur de projet

#Dialog Document Recovery
All Projects = Tous les projets
Document Recovery = Récupération de Document
Unsaved files = Fichiers non sauvegardés
Please select a file! = Veuillez séléctionner un fichier!
Please expand the folder first, then select a document to recover. =
Are you sure you want to remove this backup? = Êtes-vous sûr de vouleur supprimer cette sauvegarde?

#Dialog Find Libs
Search = Rechercher
Search Results = Résultats de la recherche
Search and press Enter = Rechercher et appuyer sur Entrer
Keywords at least 3 characters = Mots-clés d'au moins 3 caractères
Assembled = Assemblé
Verified = Vérifié
In stock = En stock
{page} of {pagecount} pages = {page} sur {pagecount} pages
Common Modules = Modules communs
User Contributions = Contributions des utilisateurs
More = Plus
Add Favorite = Ajouter aux favoris
Remove Favorite = Retirer des favoris
Add Sub Part = Ajouter un sous-composant
Untagged = Non balisé
Package = Boitier
package = boitier
Title(PartNO) =Titre(NuméroPièce) 
No Data! = Pas de données !
Quantity = Quantité
Manufacturer Part = Pièce fabricant
manufacturer Part = pièce fabricant
Manufacturer = Fabricant
manufacturer = fabricant
voltage = tension
Library = Librarie
LCSC Assembled = Assemblé par LCSC
JLCPCB Assembled = Assemblé par JLCPCB
User Contributed = Contributions des utilisateurs
Symbol = Symbole
Follow = Suivre
Types = Types
Classes = Classes
power = alimentation
Power = Alimentation
LCSC Part# = Pièce LCSC
Stock = Stock
Report Error... = Signaler une erreur...
Report Error = Signaler une erreur
Thanks for your feedback! = Merci pour vos retours!
Report error success, thanks for your report! = Rapport d'erreur réussi, merci pour votre rapport!
The content must be at least 2 characters! = Le contenu doit comporter au moins 2 caractères !
This library is user contributed, please check before using. = Cette bibliothèque est une contribution de l'utilisateur, veuillez vérifier avant de l'utiliser.
[lib]
All = Tous
System = Système
Personal = Personnel
Created = Créé
Favorite = Favoris
No Team found. Please join or create a team first. = Aucune équipe trouvé. Veuillez rejoindre ou créer une équipe d'abord.
Create a team = Créer une équipe
No follow user found. Please follow your friend first. = Aucun utilisateur à suivre n'a été trouvé. Veuillez suivre votre ami en premier.
[/lib]


BUY = ACHETER
In Stock = En stock
Out of Stock = Hors de stock
Minimum = Minimum
Distributor = Distributeur

Capacitance = Capacité
Frequency Tolerance = Tolérance de fréquence
Power (Watts) = Puissance (Watts)
Power - Max =
Frequency = Fréquence
Voltage Rating(Vdc,Vac) =
Voltage = Tension
Current Rating = Courant nominal
Rated current = Courant nominal
Resistance (Ohms) = Résistance (Ohms)
Resistance(Ohms) = Résistance(Ohms)
Inductance = Inductance
FET Type =
Current Rating(Max) = Courant nominal(Max)
Impedance @ Frequency =
Voltage - Input (Max) =
Voltage - Input (Min) =
Voltage - Supply =
Voltage - Max =
Current - Output =

#Dialog Export Your Works
Export your works = Exporter votre travail
Export to = Exporter vers
Zoom = Zoom
Image Type = Type d'image
Qualify =
0 means real size = 0 signifie taille réelle
Merged layer = Couche fusionnée
Separated layer = Couche séparée
Paged layer =
Layer = Couche
Export = Exporter
Mirror = Mirroir
TopLayer = Côté Composants
BottomLayer = Côté Cuivre
TopSilkLayer = Sérigraphie côté Composants
Protractor Properties =
BottomSilkLayer = Sérigraphie côté Cuivre

BoardOutLine =
TopAssembly =
BottomAssembly =
Mechanical =
DocumentLayer =
Inner{number} =
Substrate{number} =
Color = Couleur
Full Color =
Canvas Setting = Paramètres du canvas
Full Graphics =
Assembly Drawings =
Object Outlines =
Invalid file format = Format de fichier invalide
Failed to export file = Échec de l'exportation de fichier
Download now = Télécharger maintenant
Wire Width = Largeur du fil
Sheet = Feuille
Merged sheet = Feuille fusionnée
Separated sheet = Feuille séparée
Engine = Moteur
Exporting PDF = Exportation de PDF
Export 3D Model = Exportation du modèle 3D 
[exportDocument]
Size = Taille
[/exportDocument]

#Dialog Import Changes
Confirm Importing changes information = Confirmer l'importation des changements
You can't undo this operation, Please run a Design Rule Checking (DRC) after this operation. =
Apply Changes = Appliquer les modifications
This is a simple Design Rule Checking (DRC). =
It just can help you to find the obvious errors = Il peut juste vous aider à trouver les erreurs évidentes.
There are some unfinished nets, do you want to check the nets first? =
Yes, Check Nets =
No, Keep Going =

#Dialog Layer Manager
Configured = Configurée :
Layer Name = Nom de la couche
TopPasterLayer = Couche dessus
BottomPasterLayer = Couche dessous
TopSolderLayer = Couche Cuivre dessus
BottomSolderLayer = Couche Cuivre dessous
TopPasteMaskLayer = 
BottomPasteMaskLayer =
TopSolderMaskLayer =
BottomSolderMaskLayer =
ComponentShapeLayer =
LeadShapeLayer =
ComponentMarkingLayer =
Ratlines = Chevelu
Ratlines Color =
Manage Colors = Gérer les couleurs
BoardOutline = Bordure du Circuit
Multi-Layer = Multi-couches
Hole = Trous
DRCError = Erreurs de véricication Règles de Routage
Setting = Réglages
Drawing area = Zone de dessin
Export area = Zone d'exportation 
Transparency(%) =
Copper Layer = Couche de cuivre
Signal =
Plane = Plan
Non-Signal =
Other = Autre
Please delete all the objects of the layers first! The layers are: = Veuillez d'abord supprimer tous les objets des couches ! Les couches sont :
You are converting Signal Layer to Plane Layer, There're some non-track objects remain on following layers. Please delete the objects manually on the canvas. = Vous êtes en train de convertir une couche de signal en couche de plan, il y a quelques pistes qui restent sur les couches suivantes. Veuillez supprimer ces objets manuellement sur le canevas.
Please delete all the objects of this layer first! = Veuillez d'abord supprimer tous les objets de cette couche !

#Dialog Fabrication Output
Create Files = Générer les fichiers
Check your {0}Gerber files{1} carefully before sending them to the factory =
Download free Gerber Viewer (gerbv) = Télécharger GerbV pour visualiser les fichiers Gerber
Before generating the Gerber files = Avant de générer les fichiers Gerber
Please check the packages size and orientation carefully. = Veuillez vérifier soigneusement la taille et l'orientation des boitiers.
Please check for Design Rule Checking (DRC) errors in the Design Manager. =
Please rebuild the copper area after modifying tracks and packages. = Veuillez reconstruire la zone de cuivre après avoir modifié les pistes et les boitiers.
After generating the Gerber file, please use the {0}Gerber Viewer{1} to check whether it conforms to the design requirements. = Après avoir généré le fichier Gerber, veuillez utiliser le {0}Gerber Viewer{1} pour vérifier s'il est conforme aux exigences de conception.
Order PCB/SMT = Commande PCB/CMS
Found the complicated polygon that object cannot be generated at Gerber, please remove or replace = 
ID: {id}, Object: {object}, Location: {location} = ID: {id}, Objet: {object}, Emplacement: {location}

#Dialog DRC
Item = Elément
Value = Valeur
value = valeur
Unit = Unité
Track Width = Largeur de piste
Track to Track = Piste à piste
Track to Pad = Piste à pastille
Pad to Pad = Pastille à pastille
Via to Via = Via à via
Via Hole Size = Taille de perçage des vias
Realtime DRC =
{0} is too small! = {0} est trop petit !
Invalid DRC Rule =
Rule =
Via Diameter = Diamètre du via
Via Drill Diameter =
Net List =
Rule =
Set Rule =
Check Object to Copper Area = Vérifier l'objet dans la zone du cuivre
Show DRC Boundary while Routing =
Check Object to Board Outline =
Rule name already exists! = Le nom de la règle existe déjà !
You should not delete default rule! = Vous ne devez pas supprimer la règle par défaut !
Rule list contains invalid rule setting! = La liste de règles contient un paramètre de règle invalide !
Duplicate rule name exists! = Un nom de règle en double existe !
via diameter is smaller than via drill diameter! = Le diamètre du via est inférieur au diamètre du foret du via !
Currently rule name is not allowed to contain magical characters like . and $ = Actuellement, le nom de la règle n'est pas autorisé à contenir des caractères complexes comme . et $.
[drcRule]
All = Tous
[/drcRule]

#Dialog  Update PCB
Update PCB(Synchronizing PCB from schematics) = Mise à jour du PCB (synchronisation du PCB depuis les schémas)


#Dialog Hotkey
Change Canvas Unit =
Copy Selected Object(s) by Reference Point =
Fullscreen = Plein écran
Undo the Previous Draw = Annuler le trait précédent 
Set Canvas Origin by Coordinate =
Switch to the Next Signal Layer =
Switch to the Previous Signal Layer =
Switch object to top layer or bottom layer =
Cycle Forward to the Next Open Tabbed Document =
Cycle Backward to the Previous Open Tabbed Document =
Switch to the Previous Layer(on the Numeric Keypad) = Passer à la couche précédente (sur le clavier numérique)
Switch to the Next Layer(on the Numeric Keypad) = Passer à la couche suivante (sur le clavier numérique)
Toggle Layers Which is Not Active = Afficher les couches qui ne sont pas actives
Hotkey Setting = Réglages des touches de raccourcis
Document Type = Type de document
Shortcut = Raccourci
Function = Fonction
ALL = TOUS
SCH = SCH
Rotate Selected Objects = Faire pivoter les objets sélectionnés
Scroll or Move Selected Left = Faire défiler ou déplacer la sélection vers la gauche
Scroll or Move Selected Right = Faire défiler ou déplacer la sélection vers la droite
Scroll or Move Selected Up = Faire défiler ou déplacer la sélection vers le haut
Scroll or Move Selected Down = Faire défiler ou déplacer la sélection vers le bas
Set canvas origin to the center grid of graphics in symbol; Set canvas origin to the center of pads in footprint. =
Cross Document Paste =
Explore & Find Components = Explorer et trouver des composants
Select All = Sélectionner Tout
Cancel Current Drawing =
Save = Enregistrer
Drag Tool = Outil de déplacement
Draw Wire = Dessiner une Liaison
Draw Bus = Dessiner un Bus
Bus Entry = Entrée de Bus
Junction = Jonction
Net Flag GND =
Net Flag =
Draw Polyline = Dessiner une ligne multiple
Draw Polygon = Dessiner un polygone
Draw Bezier = Dessiner un Bézier
Draw Arc = Dessiner un arc
Draw Rect = Dessiner un rectangle
Draw Ellipse = Dessiner une élipse
Freehand Draw = Dessin à main levée
Freedraw =
Draw Text = Dessiner un texte
Edit Selected Symbol = Editer le symbole sélectionné
Draw Track = Dessiner un piste
Draw Circle = Dessiner un cercle
Cycle Select Object at Current Location =
Draw Dimension = Dessiner les dimensions
Draw Connect = Dessiner une connection
Draw CopperArea = Dessiner une zone de cuivre
Change to TopLayer;<br/>Change Selected Component's Layer to TopLayer; =
Change to BottomLayer;<br/>Change Selected Component's Layer to BottomLayer; =
Change to Inner1 =
Change to Inner2 =
Change to Inner3 =
Change to Inner4 =
Highlight Net = onnecion en Surbrillance
Place Pad = Placer une pastille
Place Via = Placer un Via
Measure = Mesurer
Change Routing Angle = Changer l'angle de routage
Change Routing Conflict = Changer le conflit de routage
Decrease Routing Width = Diminuer la largeur de routage
Increase Routing Width = Augmenter la largeur de routage
Decrease Snap Size = Diminuer l'espacement
Increase Snap Size = Augmenter l'espacement
Change Copper Zone Visible or Invisible = Changer la zone de cuivre en visible ou invisible
Rebuild All Copper Area = Reconstruire toutes les zones de cuivre
Toggle PCB Net Display =
Show Property Dialog When Placing Object;<br/>Show Location Setting Dialog When Pasting Object(s) =
Show Property Dialog When Placing Object;<br/>Show Absolute Offset Dialog When Selecting Object(s);<br/>Show Location Setting Dialog When Pasting Object(s) =
Show Relative Offset Dialog When Selecting Object(s) = Afficher la boîte de dialogue de décalage relatif lors de la sélection d'un ou de plusieurs objets
Open the FAQ Page = Ouvrir la page de la FAQ
Move Object(s) by Reference Point = Déplacer un ou plusieurs objets par point de référence
Choose Favorite Track Width While Routing = Choisir la largeur de piste préférée pendant le routage
Copy Selected Object(s) and Paste Repeatedly = Copier le ou les objets sélectionnés et les coller de manière répétée

#My Projects Tree Menu
New Project = Nouveau Projet
New Schematic = Nouveau schéma
New PCB = Nouveau PCB
New Spice Subckt =
Modify = Modifier
Delete = Supprimer
Add sub part = Ajouter une sous-partie
Clone = Dupliquer
Version History = Historique des versions
Refresh List = Rafraichir la liste
Create New Project = Créer un nouveau projet
Delete = Supprimer
Attachment = Pièce jointe
Archive = Archiver
Transfer = Transferer
Manage Project = Gérer le projet

#Dialog Verify Package
Footprints Verification = Vérification des empreintes

#Dialog Edit Polygon Pad points
Edit Points =
Center point is outside the pad =
Hole should be inside the pad = Le trou doit être à l'intérieur de la pastille
Hole is draggable = Le trou peut être déplacé

#My Part Tree Menu
Clone = Dupliquer
Reload parts = Recharger les éléments
Layers = Couches

#Dialog Preferences
Language = Langue
Display Name = Nom d'affichage
HotKey Sync = Synchronisation des touches de raccourci
My Theme Sync = Synchronisation de mon thème
Document Recovery Setting = Réglage de la récupération des documents
Enable auto backup = Activer la sauvegarde automatique
Maximum backup level = Niveau de sauvegarde maximum
Auto backup interval = Intervalle de sauvegarde automatique
minutes =  minutes
Save to Server = Enregistrer sur le serveur
Load from Server = Charger à partir du serveur


#Dialog Schematic Library Wizard
Symbol Wizard = 
Style = Style
Picture = Image
Pin Names = Noms des broches
Contributor = Contributeur
contributor = contributeur
owner = propriétaire

#Dialog Annotate
Annotate = Annoter
Scope = Pointer
Active Schematic only = Uniquement le Schéma actif
All Opened Schematics = Tous les Schémas ouverts
Method = Méthode
Re-annotate all = Ré-annoter Tout
Keep existing annotation = Conserver les annotations existantes
Direction = Direction
Rows = Lignes
Cols = Colonnes
Reset = Remise à zéro

#Dialog Order
Order... = Commander...
PCB Qty. = Quantité de Circuits
PCB Thickness = Epaisseur du circuit
PCB Dimension = SDimensions du circuit
Automatic calculation = Calcul automatique
PCB Color = Couleur du circuit imprimé
Green = Vert
White = Blanc
Blue = Bleu
Red = Rouge
Yellow = Jaune
Black = Noir
Purple = Violet
Copper = Cuivre
Gold = Or
Silver = Argent
Surface Finish = Finition de surface
Hasl = Brasure
Hasl(Lead Free) = Brasure sans plomb
ENIG = ENIG

#Dialog Hot Key config
Restore All Default Shortcuts = Restaurer les raccourcis par défaut
Save Changes = Enregistrer les Changements



#Dialog Polyline Maybe Wire
To connect electrical elements, please use Wire (W hotkey) and not Line (L hotkey). =

Anonymous File = Fichier anonyme
Anonymous File can not be cloned, but you can open it, then save it as a new file. = Un fichier anonyme ne peut pas être cloné, mais vous pouvez l'ouvrir, puis l'enregistrer comme un nouveau fichier.
Free Documents = Documents gratuits
You must close the file before delete it! = Vous devez fermer le fichier avant de le supprimer ! 
Offline Project = Projet hors ligne

#Message box
Confirmation = Confirmation
Alert = Alerte
Information = Information
information = Information
Prompt = Prompt
Error = Erreur
error = Erreur
error! = Erreur !
Warning = Attention
Imported ok! = Importation Correcte !
Some changes have not been saved. = Certaines modifications n'ont pas été enregistrées
Your file hasn't been saved. Please save first! = Votre fichier n'a pas été sauvegardé. Veuillez le sauvegarder d'abord!
Your file hasn't been saved. Are you sure you want to close it? = Votre fichier n'a pas été sauvegardé. Êtes-vous sûr de vouloir le fermer?
Error! Please try again later. = Erreur! Veuillez réessayer plus tard.
Are you sure you want to reload this page? = Êtes-vous sûr de vouleur rafraîchir cette page?
Are you sure you want to leave this page? = Êtes-vous sûr de vouleur quitter cette page?
Confirm Reload = Confirmer le rafraîchissement
Confirm Close = Confirmer la fermeture
Reload this page = Rafraîchir cette page
Leave this page = Quitter cette page
Stay on this page = Rester sur cette page
Don't reload = Ne pas rafraîchir
No connect flag only can be placed on Pin dot or the wire which is connected one Pin. =
can not be placed on the wire which is placing No Connect Flag. =
The footprint transfer to LCSC library class successfully =
Device/Footprint goes into "SMT Device/Footprint Verified" list successfully =

Load failure! = Erreur du chargement
Load projects failed = Échec du chargement des projets
error info = Information sur l'erreur
error information = Information sur l'erreur
Guest can't create a new project. Please login! = Un invité ne peut pas créer un nouveau projet. Veuillez vous connecter !
Please create a project before you do this! = Vous devez d'abord créer un nouveau projet !
Add Part success = Ajout d'élément réussi
Click the new part and then edit it! = Cliquez sur la nouveau composant, puis modifiez-le !
Delete my work = Effacer mon travail
Delete my work. (Only deletes it from this list but not from the server) =
Do you confirm this? = Vous confirmez ?
Successfully deleted! = Effacement réussi !
Successfully Copied! = Copié avec succès !
Cloning success! = Copie Réussie !
Your title is too short! = Le titre est trop court !
Remove this part = Supprimer l'élément
Find and Jump to ... = Chercher et Aller vers...
Please type the prefix, such as U1, R1, C1 = Veuillez saisir un préfixe (U1, R1, C1, ...)
Zoom as 1:1, you can print it and then create artwork for etching the PCB. = Zoom 100 %. Vous pouvez imprimer puis créer votre typon.
Exporting your works! = Exportation en cours !
Guests can't import a file. Please login! = Les invités ne peuvent pas importer un fichier. Vous devez vous inscrire !
Please create a project before you import a file! = Vous devez créer un projet avant d'omporter un fichier !
Import your LTspice file! = Importer votre fichier LTspice !
Open LTspice file = Ouvrir le fichier LTspice
Please make sure the selected LTspice file is a file saved in LTspice V and above. = Veuillez vous assurer que le fichier LTspice sélectionné est un fichier enregistré dans la version V ou supérieur.
Saved successfully! = Enregistrement réussi !
Save failed! = Enregistrement échoué !
Can not place parts into this document. = Vou ne pouvez pas placer d'éléments dans ce document.
User Package = Boitier de l'utilisateur
System Package = boitier du système
File error = Erreur de fichier
Please save your file first! = Vous devez d'abord enregistrer votre fichier !
Email address is too short! = L'adresse email est trop courte !
You have not selected a file to upload. = Vous n'avez pas sélectionné de fichier à transférer.
Update = Mettre à jour
No changes, the PCB already matches the schematic! =
Only public files can be shared = Seuls les fichiers publiques peuvent être partégés
Conversion to PCB has failed! = Erreur lors de la conversion en circuit !
Your username is too short! = Le Nom Utilisateur est trop court !
Your password is too short, it must be more than 6 characters! = Le mot de passe est trop court (6 caractères au minimum) !
Conflicting shortcut =
There is an empty PCB file. Please first run Convert Schematic to PCB... from the schematic = Le Circuit n'existe pas. Vous devez d'abord créer un Circuit à partir du Schéma...
This file has been modified, are you sure you want to run this simulation before saving it first? = Le fichier a été modifié. Voulez-vous quand même lancer la simulation ?
Please enter the Maximum Timestep! = Veuillez saisir la durée maximale d'un pas de simulation !
Please enter the Stop Time! = Veuillez saisir la Fin de simulation !
All of these fields are needed. = Tous les champs sont requis.
Either your spice netlist is too big or the server is busy. Please try again later. = Votre netlist est trop grande ou le serveur est occupé. Réessayez plus tard.
Your spice netlist is too big! Try breaking your circuit into smaller simulatable blocks. = Votre netlist est trop grande ! Essayez de découper votre ciruit en blocs plus petits.
Too many users in simulation. Please try again later! = Trop de connexions pour la simulation. Réessayez plus tard.
Due to limited server resources, please wait 10 seconds for the interval in every time simulation. =
Your circuit is too complex, we have not enough CPU resource to support this simulation, please reduce your circuit as small as you can. =
Simulation is queuing, try again after 30s. = La simulation est en attente, réessayez après 30s. 
Timeout = Délai d'attente
Demo accounts don't support simulation, please login first = Les comptes de démonstration ne permettent pas la simulation, veuillez d'abord vous connecter.
Please login first = Veuillez vous connecter d'abord
The schematic is showing errors, please check the simulation report carefully! = Le Schéma comporte des erreurs, Vérifiez la simulation attentivement !
Simulation too long, maybe your schematic is too complex. = La simulation est trop longue. Votre schéma est trop complexe.
Non-simulated file = Fichier non simulé
This file can only be opened in standard mode. To open it, please switch to standard mode. = Ce fichier ne peut être ouvert qu'en mode standard. Pour l'ouvrir, veuillez passer en mode standard.
Load your preferences success! = Chargement de vos préférences réussi !
Save your preferences success! = Enregistrement de vos préférences réussi !
Update subckt ok! = Mise à jour du sous-circuit réussie !
Clone your file = Dupliquer ce fichier
Please type a new file name = Veuillez saisir un nouveau nom de fichier
Create file failure! = Erreur de création du fichier !
Schematics and PCBs can't be imported under My Libs folder, please choose a different folder =
Libraries to be imported under My Libs folder = Librairies à importer dans le dossier 'Mes Librairies'
Please choose only the libraries needed = Sélectionnez seulement les librairies nécessaires
Maximum import is 200 libs at one time! = Importation sumultanée de 200 librairies au maximum !
You libraries will be found under the My Libs folder = Vos librairies sont dans le dossier 'Mes Librairies'
Add to Library = Ajouter à la librairie
No items have been checked! = Aucun élément sélectionné !
Nothing was found, please create it for yourself = Rien trouvé, Créez-le pour vous même
Search result = Résultat de la recherche
At least 3 characters needed = Au moins 3 caractères sont requis
Add to my Favorite Parts = Ajouter à mes 'Composants Favoris'
Added it OK. Please find it in your Favorite Parts = Ajout réussi dans le dossier 'Composants Favoris'
Please select its parent node = Sélectionnez le noeud supérieur
Libraries can not be exported as active project pdf. = Les librairies ne peuvent être exportées en pdf.
Error:No GND = Erreur : pas de GND
This circuit does not have GND. Please select GND from the circuit tool to add to the circuit. = Ce circuit n'a pas de GND. Veuillez sélectionner GND dans l'outil de circuit pour l'ajouter au circuit.
Current circuit doesn't has Voltage Resource or Current Resource symbol, please place it first at left side EElib or Spice Library. =
Probe can not connect with ground(GND)! = La sonde ne peut pas se connecter à la masse (GND) !
Spice symbols's properties can't be empty. = Les propriétés des symboles Spices ne peuvent pas être vides. 
Error:No Spice Symbol = Erreur : Aucun symbole Spice
Simulation limit = Limite de simulation
There is a multimeter in the circuit that needs to be simulated using the emulation command .tran or .op = Le circuit contient un multimètre qui doit être simulé à l'aide de la commande d'émulation .tran ou .op. 
An oscilloscope exists in the circuit and needs to be simulated using the simulation command .tran = Un oscilloscope existe dans le circuit et doit être simulé à l'aide de la commande de simulation .tran.
There are components in this circuit that do not have a simulation model. Please use the base library component of the simulation mode for simulation. = Certains composants de ce circuit ne disposent pas d'un modèle de simulation. Veuillez utiliser le composant de la bibliothèque de base du mode de simulation pour la simulation.
Circuit does not have a probe = Le circuit n'a pas de sonde
Make sure your pin numbers are even numbers = Vérifiez que le nombre de broches soit pair
Duplicate Components Prefix = Préfixe des composants dupliqués
All components are hidden successfully! = Tous les composants sont cachés avec succès !
All ratlines are hidden successfully! =
Hidden the ratline of net {netName} successfully! =
Duplicate Component Prefix = Préfixe de composant en double
{0} exist = {0} existe
There are some invalid packages, are you sure? = Il y a des boitiers non valides, confirmez-vous ?
Invalid Characters, library only allows [0-9a-zA-Z-_]
Annotation success = Annotation réussie
If you accept this annotation operation, please save your files. If not, close your files without saving. = Si vous confirmez cette opération, veuillez enregistrer vos fichiers. Sinon, ils seront fermés sans enregistrement.
This file can't be saved under libs project. Please choose other project or create a new project = Ce fichier ne peut pas être enregistré sous le projet libs. Veuillez choisir un autre projet ou créer un nouveau projet
Your file is unsaved. = Votre fichier n'est pas enregistré
You can close the editor now. Have a good day! = Vous pouvez maintenant fermer l'éditeur. Bonne journée !
Successfully logged out = Déconnexion réussie
You have at least one unsaved file open. Please save it or close it. = Vous avez au moins un fichier non sauvegardé ouvert. Veuillez l'enregistrer ou le fermer.
Please select a reference point = Veuillez sélectionner un point de référence
Please save your file before this operation = Veuillez sauvegarder votre fichier avant cette opération
Please open a PCB document = Veuillez ouvrir un document PCB
Please save your file before '{0}'. = Veuillez enregistrer votre fichier avant '{0}'.
Please try again after saving this file. = Réessayez après avoir enregistré vos fichiers
This text can not be empty! = Ce texte ne peut pas être vide !
Export to Altium fail, please try again or contact us. = L'exportation vers Altium a échoué, veuillez réessayer ou nous contacter.
Connecting to server = Connexion au serveur
Please login before asking for help = Veuillez vous connecter avant de demander de l'aide
This file has been modified, please save it first! = Ce fichier a été modifié. Enregistrez le avant de poursuivre !
Remove this param = Supprimer ce paramètre
You cannot drag a part to the canvas, please click the part and move the cursor to the canvas and then right-click to place. =
Undo/Redo temporary error =
We are sorry but there is an unpredictable error in the undo/redo process. This problem will be fixed soon but in the meanwhile it is safe to continue working on your design. =
The schematic has duplicate prefixes of the components, please make them unique. You can check them using the Design Manager. =
Found duplicated prefix components, can not Import Changes, please modify the duplicated prefix or delete related component. =
Please click the below help button to find out how to fix this problem. = Veuillez cliquer sur le bouton d'aide ci-dessous pour savoir comment résoudre ce problème.
Please create a board outline! Click the help button to find out how to create a board outline. = Veuillez créer le countour du circuit ! Cliquez sur le bouton d'aide pour savoir comment créer un contour.
Can not fetch files from server, please check your network and try again = Impossible de récupérer les fichiers du serveur. Vérifiez votre connexion et réessayez.
Please open a schematic first! = Ouvrez d'abord un schéma !
Can not find the schematic of this PCB =
invalid points! = points invalides !
This file does not support this operation. = Ce fichier ne supporte pas cette opération.
Net Name Conflict =
Net name =
{0} are in the same wire, please remove others and just keep one. = {0} sont dans le même fil, veuillez supprimer les autres et n'en garder qu'un.
This field can't be removed! = Ce champ ne peut pas être supprimé !
Annular ring of the pad/via is too small =
The size of the hole cannot exceed the size of the pad = La taille du trou ne peut pas dépasser la taille de la pastille.
Are you sure you want to create a multi-sheet designs? = Êtes-vous sûr de vouloir créer un modèle à feuilles multiples ? 
Are you sure you want to create a {0}multi-sheet designs{1}? = Etes-vous sûr de vouloir créer un {0}modèle à feuilles multiples{1} ?
Please build the copper area! Click the help button to find out how to build the copper area. = Veuillez construire la zone de cuivre ! Cliquez sur le bouton d'aide pour savoir comment construire la zone de cuivre.
Suggest to set a package for this component first! = Il est conseillé de définir d'abord un boitier pour ce composant !
Please select an opened document first. = Veuillez d'abord sélectionner un document ouvert.
Some files failed to load. Please reload the page. = Le chargement de certains fichiers a échoué. Veuillez recharger la page.

#UI Intro
Skip = Sauter
« Back = « Retour
Next » = Suivant »
Done = Terminer
This is the user management menu. = Ceci est le menu de gestion de l'utilisateur
This is the toolbar. = Ceci est la barre d'outils
This is the navigation list. Under here you can find projects, files, parts and libraries. = Ceci est la liste de navigation. Sous cette rubrique, vous pouvez trouver des projets, des fichiers, des pièces et des bibliothèques.
Show or hide the toolbar to the top of the window here. = Afficher ou cacher la barre d'outils vers le haut de la fenêtre ici.
Show, resize or hide the left sidebar to the left of the window here. = Afficher, redimensionner ou cacher la barre latérale gauche vers la gauche de la fenêtre ici.
Show or hide the right sidebar to the right of the window here. = Afficher ou cacher la barre latérale droite vers la droite de la fenêtre ici.

#Standard libs
Passive Components = Composants passifs
Power Supply = Alimentation
Diodes = Diodes
Regulator = Régulateurs
Transistor = Transistors
Transformers = Tranformateurs
Gates = Opérateurs Logiques
Vacuum Tubes = Tubes électroniques
Switch = Interrupteurs
Relay = Relais
Capacitor(US) = Condensateurs (US)
Capacitor(EU) = Condensateurs (EU)
Capacitor(EU)2 = Condensateurs (EU)2
Electrolytic Capacitor(US) = Condensateurs Chimiques (US)
Electrolytic Capacitor(EU) = Condensateurs Chimiques (EU)
Electrolytic Capacitor(US)2 = Condensateurs Chimiques (US)2
Electrolytic Capacitor(EU)2 = Condensateurs Chimiques (EU)2
Inductor(US) = Inductances/Bobines (US)
Inductor(EU) = Inductances/Bobines (EU)
Potentiometer_US = Potentiomètre_US
Potentiometer_EU/IEC = Potentiomètre_EU/IEC
Potentiometer_3D = Potentiomètre_3D
Resistor(US) = Résistances (US)
Resistor(EU) = Résistances (EU)
Resistor 45 Deg(US) = Résistances 45 degrés (US)
Resistor 45 Deg(EU) = Résistances 45 degrés (EU)
Variable Capacitor(US) = Condensateurs variables (US)
Variable Capacitor(EU) = Condensateurs variables (EU)
Variable Resistor(US) = Résistances variables (US)
Variable Resistor(EU) = Résistances variables (EU)
Variable Inductor(US) = Inductances variables (US)
Variable Inductor(EU) = Inductances variables (EU)
Varistor = Varistances
Inductor2(US) = Inductances/Bobines (US)2
Inductor2(EU) = Inductances/Bobines (US)2
Battery = Batteries/Accumulateurs
Voltage Source = Sources de tension
Current Source = Sources de courant
CCCS(Current Controlled Current Source) = Sources de courant commandés en courant
CCCS2(Current Controlled Current Source) = Sources de courant commandés en courant-2
VCCS(Voltage Controlled Current Source) = Sources de courant commandés en tension
VCVS(Voltage Controlled Voltage Source) = Sources de tension commandés en tension
CCVS(Current Controlled Voltage Source) = Sources de tension commandés en courant
CCVS2(Current Controlled Voltage Source) = Sources de tension commandés en courant-2

BV(Behavioral Voltage Sources) = Sources de tension programmables
BI(Behavioral Voltage Sources) = Sources de courant programmables
Epoly(Non-linear Voltage Source) = Sources de tension non-linéaires
Gpoly(Non-linear Current Source) = Sources de courant non-linéaires

Diode = Diode
LED = DEL
LED_3D =
Schottky Diode = Diode Schottky
Varactor Diode = Diode Varactance
Zener = Diode Zener
Unidirectional TVS Diode = Diode TVS uni-directionnelle
Bidirectional TVS Diode = Diode TVS bi-directionnelle
Diac = Diac
Bridge = Pont
78XX = 78XX
79XX = 79XX
LM317 = LM317
LM337 = LM337
TL431 = TL431
BJT(NPN) = Transistor bipolaire NPN
BJT(PNP) = Transistor bipolaire PNP
MOSFET(Nch) = MOSFET canal N
MOSFET(Nch) Depletion Four-pins = MOSFET canal N à Déplétion (4 broches)
MOSFET(Nch) Enhancement = MOSFET canal N à Enrichissement
MOSFET(Nch) Enhancement Four-pins = MOSFET canal N à Enrichissement (4 broches)
MOSFET(Pch) = MOSFET canal P
MOSFET(Pch) Depletion Four-pins = MOSFET canal P à Déplétion (4 broches)
MOSFET(Pch) Enhancement = MOSFET canal P à Enrichissement
MOSFET(Pch) Enhancement Four-pins = MOSFET canal P à Enrichissement (4 broches)
JFET(Nch) = Transistor à effet de champ (JFET) Canal N
JFET(Pch) = Transistor à effet de champ (JFET) Canal P
Darlington NPN = Darlington NPN
Darlington PNP = Darlington PNP
MESFET(Nch) = MESFET canal N
MESFET(Pch) = MESFET canal P

IGBT = IGBT
SCR = Thyristor
Triac = Triac
Transform(US) = Tranformateur (US)
Transform(EU) = Tranformateur (EU)
Transfrom(NEUTRAL-CTR TAP)(US) = Tranformateur avec neutre (US)
Transfrom(NEUTRAL-CTR TAP)(EU) = Tranformateur avec neutre (EU)
Mutual Inductors = Inductance mutuelle
Mutual Inductors2 = Inductance mutuelle-2
Or Gate = Opérateur OU
Xor Gate = Opérateur OU exclusif
And Gate = Opérateur ET
Nor Gate = Opérateur OU-NON
Nand Gate = Opérateur ET-NON
Not Gate = Opérateur NON
Xnor Gate = Opérateur NON-OU exclusif
Tube Diode = Tube Diode
Tube Triode = Tube Triode
Tube Tetrode = Tube Tetrode
Tube Pentode = Tube Pentode
Voltage Controlled Switch = Interrupteur commandé en tension
Current Controlled Switch = Interrupteur commandé en courant
SPST ON = Contact Fermé
SPST OFF = Contact Ouvert
Fuse = Fusible
555 = NE555
555(Style2) = NE555-2
Speaker = Haut Parleur
XTAL = Quartz
5pin Operational Amplifier = AIL 5 broches
3pin Operational amplifier = AIL 3 broches
Transmission Line = Ligne de transmission
Voltmeter = Voltmètre
Ammeter = Ampèremètre
LAMP = Lampe
Opto Transistor = Opto-Transistor

#Server Message
Need login = Vous devez vous identifier
Bad password = Erreur de mot de passe
We can't find your username or your email, please check it! = Nom d'utilisateur ou adresse mail inconnu, vérifiez !
Make sure your uploaded file size is less than 3MB! = Vérifiez que votre téléchargement ne dépasse pas 3 Mo!
Bad file type = Type de fichier incorrect
Empty file or bad file type, ensure your file is Eagle 6.0+ = Mauvais nom de fichier ou fichier inexistant. Vérifiez que la version d'Eagle est supérieure à 6.0+
This operation not supported on demo account = Opération non autorisée avec un compte de démonstration
Can not share this file under a private project, please set the active project to public! = Impossible de partager ce fichier dans le cadre d'un projet privé, veuillez définir le projet actif comme public !
Login Failed Too many attempts. If you forgot your password, please {0}reset your password{1} or send an email to support@easyeda.com = Connexion échouée Trop de tentatives. Si vous avez oublié votre mot de passe, veuillez {0}réinitialiser votre mot de passe{1} ou envoyer un e-mail à support@easyeda.com

#Dialog Common Buttons
Common Buttons Setting = Réglage des boutons
Menu Setting... = Réglage du menu...
Show/Hide = Monter/Cacher
Move Up = Monter
Move Down = Descendre
Reset All = Réinitialiser tout
Zoom = Zoom
Place Pin = Placer une broche

#System Setting Dialog
System = Système
Zoom Mode = Mode zoom
Scroll Key =
CTRL + Scroll =
Canvas Coordinate System =
SVG Coordinate = Coordonnées SVG
Cartesian Coordinate = Coordonnées cartésiennes
Open Wizard Dialog for New Schematic = Ouvrir l'assistant pour un nouveau schéma
Default Unit = Unité par défaut
Canvas Zoom Effect =
Quality Priority = Priorité à la qualité
Speed Priority = Priorité à la vitesse
Rotation Step = Pas de rotation
Add Teardrop Automatically = Ajouter automatiquement une teardrop
Assign Net for Free Track/Arc/Circle =
Open Wizard Dialog for New PCB = Ouvrir l'assistant pour un nouveau PCB
Rebuild Plane Automatically = Reconstruction automatique du plan
The Track's Routing Follows Component's Rotation =
Display Pad's Number and Net =
Favorite Track width = Largeur de piste préférée
Track Width Setting = Réglage de la largeur des pistes


#Dialog Access Control
Permissions = Autorisations
Operations = Opération
Access Control = Contrôle d'accès
Project Access Control = Contrôle d'accès aux projets
Reject = Rejeter
Add User = Ajouter un utilisateur
Bad email address = Adresse mail invalide
# error info from backend
Can't find this email address in EasyEDA. Your partner must be an EasyEDA user. = Impossible de trouver cet e-mail dans EasyEDA. Votre partenaire doit être un utilisateur de EasyEDA.

#Dialog waveForm
Grid Background = Arrière plan de la grille
Pane Background = Arrière plan du panneau
WaveForm Config = Configuration de la courbe
Export Waveform = Exporter la courbe


#attr-canvas-grid-style
dot = points
line = lignes

#attr-canvas-frame-size
Other = Autre
A4 Portrait = A4 PORTRAIT
A4 Landscape = A4 paysage
A3 Portrait = A3 PORTRAIT
A3 Landscape = A3 paysage
A2 Portrait = A2 PORTRAIT
A2 Landscape = A2 paysage
A1 Portrait = A1 PORTRAIT
A1 Landscape = A1 paysage
Landscape = Paysage
Portrait = Portrait

#Stroke Style
solid = plein
dashed = tirets
dotted = pointillé

#Solid Region
Solid Region = Région solide
Type = Type
type = type

#Dialog Libs Management
Report error = Signaler une erreur
Please give us some information to help us find the problem. = Veuillez nous donner quelques informations pour nous aider à trouver le problème.
Cannot place parts into this document: Schematic Symbols can only be placed into a Schematic; PCB Footprints can only be placed into a PCB. =
Save it as a favorite part = Sauvegardez-le comme composant favori
Only logged-in users can save this component as a Favorite Part but guest (Anonymous) users can place this component into their design directly. Would you like to place this component now? =

#Others
Find libs = Trouver une librairie
My Projects = Mes Projets
My Parts = Mes Composants
My Modules = Mes Modules
Assembly LCSC Components = Composants assemblés par LCSC
Modules = Modules
SCH Module = SCH Module
PCB Module = PCB Module
System IC = Circuits intégrés Système
LCSC (Official) = LCSC (officiel)
LCSC Electronics = LCSC Electronics
Simple Mode = Mode simple
Expand Mode = Mode étendu
Help Verify = Aide à la vérification
Favorite Parts = Composants Favoris
Shared With Me = Partager avec moi
Preview = Aperçu
Preview Window = Fenêtre d'aperçu 
System Default = Système par défaut
User Defined = Défini par l'utilisateur
Theme = Thème
Theme Setting = Réglage du thème
Close = Fermer
Open = Ouvrir
Toggle toolbar = Basculer la barre d'outils
Toggle left bar = Basculer barre de gauche
Toggle right bar = Basculer barre de droite
Reload = Recharger
Mouse-X = Souris-X
Mouse-Y = Souris-Y
Mouse-DX = Souris-DX
Mouse-DY = Souris-DY
Bus entry x1 = Entrée bus x1
Bus entry x2 = Entrée bus x2
Bus entry y1 = Entrée bus y1
Bus entry y2 = Entrée bus y2
Yes = Oui
No = Non
OK = OK
Confirm = Confirmer
Continue = Continuer
Cancel = Annuler
Update = Mettre à jour
Bus entry = Entrés de Bus
Filter = Filtre
Check = Vérifier
Copy the contents of this box into a text editor, then save the file. Paste the edited text back into this box and click Apply to update the display. = Copiez le contenu de cette case dans un éditeur de texte, puis enregistrez le fichier. Collez à nouveau le texte modifié dans cette zone et cliquez sur Appliquer pour mettre à jour l'affichage.
Copy the contents of this box into a text editor, then save the file with a .svg extension. You can edit it in Inkscape or open it in your browser. = Copier le contenu de cette fenêtre dans le Bloc-notes et enregistrer le fichier avec une extension SVG. Vous pouvez alors le modifier avec Inkscape ou l'ouvrir dans un navigateur.
Content is too big to show, you can download it directly. = Le contenu est trop volumineux pour être affiché, vous pouvez le télécharger directement.
SVG format = Format SVG
SVG File = Fichier SVG
Description should be no more than 250 letters = La descripton ne doit pas dépasser 250 caractères
The file save operation has timed out. Try again and check your Internet connection. = Durée d'enregistrement dépassée. Vérifiez votre connexion internet et réessayez à nouveau.
Export Netlist = Exporter la NetList
Notifications = Notifications
Please select txt or json files. = Veuillez sélectionner des fichiers txt ou json.
Failed to read file [{file}] = Impossible de lire le fichier [{file}].
[{file}] is not a valid json file =[{file}] n'est pas un fichier json valide
Invalid parameters! = Paramètres invalides !
Download = Télécharger
Start = Commencer
You have unsaved files, are you sure you want to log out without saving the files? = Vous avez des fichiers non sauvegardés, êtes-vous sûr de vouloir vous déconnecter sans les sauvegarder?
Please use the web version to run this function. = Veuillez utiliser la version web pour utiliser cette fonction.
Please save this file to you project! = Veuillez enregistrer ce fichier dans votre projet !
Nothing changed = Rien n'a changé
Delete Node = Supprimer le noeud
This layer is invisible. = Cette couche est invisble
When the solid region is Board Cutout, please set the layer to Multi-Layer. =
You should not try to assign a net to a Board Cutout solid region. =
Net Length =
You can place a Pin in the schematic, but don't forget to group all of the Pins to a schematic component. Please click the help button to find out how to group them. If you just want to mark the wire, please use NetPort or NetLabel. =
Please input the modification = Veuillez saisir la modification
The content must be between {0} and {1} characters = Le contenu doit être compris entre {0} et {1} caractères.

Coming soon = Bientôt disponible
No tool = Aucun outils
Help us translate into your language = Aidez nous à traduire dans votre langue
Pad = Pastille
Via/Hole = Via/Trou
PCB Layers = Couches de cuivre
Order PCB = Commander un Circuit
Share = Partagé
Free = Gratuit
Small = Petit
Medium = Moyen
Big = Large


Embed = Embarqué
HTML = HTML
URL = URL
BBCode = BBCode
PNG = PNG
Exporting as = Exporter comme ...
Exporting as image = Exporter comme image
Exporting as {0}SVG{1} file. = Exporter comme fichier {0}SVG{1}.
Exporting as pdf is recommended: pdf gives good quality printed output and a small file size. = Exportation en pdf recommandée : le pdf est de petite taille et permet une bonne qualité d'impression.
Generate PCB Fabrication File(Gerber) =
PenWidth-Increase =

#Generate Gerber
Generate Gerber = Générer Gerber
Gerber View = Visualisation du Gerber
Dimensions(Estimated) = Dimensions(Estimées)
PCB Qty = Qté PCB
Copper Weight = Poids du cuivre
PCB Price = Prix PCB
Estimated Delivery Time = Temps de livraison estimé

HASL(with lead) = Etain(avec plomb)
LeadFree HASL-RoHS = Etain sans plomb ROHS
ENIG-RoHS = 
Would you like to do Design Rule Checking (DRC) before generating the Gerber files? =
Yes, Check DRC = Oui, vérifiez le RDC
No, Generate Gerber = Non, générer le Gerber
This PCB has uncompleted connection(s), do you want to check the connection(s)? = Ce PCB a une ou plusieurs connexions non complétées, voulez-vous vérifier la ou les connexions ?
Yes, Check Connection(s) = Oui, vérifier la ou les connexions
It will then redirect to the web site of a third-party JLCPCB with which we cooperate. Are you ready? = Il sera alors redirigé vers le site web tiers JLCPCB avec lequel nous coopérons. Êtes-vous prêts ?
Failed to submit your order, please contact us via support@easyeda.com for help. =  Impossible de soumettre votre commande, veuillez nous contacter via support@easyeda.com pour obtenir de l'aide.
Failed to submit your order, please contact us via QQ 800821856. = Impossible de soumettre votre commande, veuillez nous contacter via QQ 800821856.
Order data generated finish, please click OK button and continue. = Les données de la commande générées sont terminées, veuillez cliquer sur le bouton OK et continuer.
[generateGerber]
Layers = Couches
[/generateGerber]

[version]
Switch = Interrupteurs
[/version]


Export your file, then print it yourself. = Exporter le fichier puis imprimez-le.
Trace width is too small = Piste trop étroite
Share = Partagé

Images Property = Attibuts de l'image
Connect Pad to Pad = Connecter pastille à pastille
Copper Area = Zone de cuivre
Dimension = Dimension


Please check that you have used Wire and not Line to connect electrical elements. =
PCB Fabrication Prices & capabilities = Prix et capacités de fabrication des PCB
Flip all texts on bottom layer = Retourner tous les textes sur la couche inférieure
Create New Document = Créer un nouveau document
General Package = Boitier générique
General Packages = Boitier générique
favorite Package = boitier préféré
Board Cutout = Découpe de la carte
Surface Mount = Montage en surface
JLCPCB Part Class =
base = 
expand =
recommend = recommandé
Basic Part = Composant de base 
Extended Part = Composant supplémentaire
Recommended Part = Composant recommandé
smtWeld =
thtWeld =
manualWeld =
furnaceWeld =
Multi-Layer = Multi-couches
Markdown Syntax = Syntaxe au format Markdown
Markdown supported = Prise en charge de Markdown
Read only = En lecture seule
Read/Write = Lecture/Ecriture
More Libraries... = Plus de librairies...
Decompress failed! = Échec de la décompression !
Load failed! = La chargement a échoué !
Loading = Chargement
No Result = Aucun résultat

#Dialog Place Pin in schematic warning
Place Pin in schematic warning =
You can place a Pin in schematic, but don't forget to group all of the Pins to a schematic component, please click the help button to find out how to group them. If you just want to mark the wire, please use NetPort or NetLabel. =
I know. Do not show this again. = Je sais. Ne montrez plus ce genre de choses.

#Extensions Setting
Extensions Setting = Réglage des extensions
Remove = Retirer
Disable = Désactiver
Enable = Activer
(Disabled) = (Désactiver)
(Enabled) = (Activer)
Load Extension = Charger l'extension
Enable or disable will be applied after reload page = L'activation ou la désactivation sera appliquée après le rechargement de la page.
Your browser cannot run this function. = Votre navigateur ne peut pas exécuter cette fonction.
Your browser mode does not support indexedDB. Some features may not work properly. Are you using Private Browsing Mode? = Le mode de votre navigateur ne prend pas en charge IndexedDB. Certaines fonctionnalités peuvent ne pas fonctionner correctement. Utilisez-vous le mode de navigation privée ?
Extension Files = Fichiers d'extension
Extension ID = Extension ID
Select Files = Sélectionner les fichiers

#Scripts
Script = Script
Scripts = Scripts
Script Content = Contenu du script
Load from js file = Chargement à partir d'un fichier js
UTF-8 encoded js file = Fichier js encodé en UTF-8
Description = Description
description = description
Not a *.js file = Pas un fichier *.js
Failed to read file = Impossible de lire le fichier
System scripts cannot be modified = Les scripts du système ne peuvent pas être modifiés
Create Subfolder = Créer un sous-dossier
Create Script = Créer un script
Install Script = Installer le script
Install = Installer
Are you sure you want to remove this script? = Êtes-vous sûr de vouloir supprimer ce script ?
Folder Name = Nom du dossier
Rename = Renommer
Please select a script = Veuillez sélectionner un script
Failed to load script = Échec du chargement du script
Run Script = Exécuter le script
Load Script = Charger le script
Title is required = Un titre est nécessaire
Script content is required = Le contenu du script est requis
System Scripts = Scripts du système
User Scripts = Scripts utilisateur
You can right click on the tree nodes. =

#PCB photoView toolbar
Top Side = Face supérieure
Bottom Side = Face inférieure
With Silk Layer = Avec la couche de sérigraphie
No Silk Layer = Sans la couche de sérigraphie
Photo View = Vue photo

#check update
Check Update = Vérifier les mises à jour
EasyEDA Editor {ver} is released. Would you like to switch to the new version now? = EasyEDA Editor {ver} est disponible. Voulez-vous passer à la nouvelle version maintenant ?
LCEDA Editor {ver} is released. Would you like to switch to the new version now? = LCEDA Editor {ver} est disponible. Voulez-vous passer à la nouvelle version maintenant ?
Switch to New Version = Passer à la nouvelle version
Next Time = Une prochaine fois

#download project dialog
Generating download link... = Génération du lien de téléchargement...
Download project now = Télécharger le projet maintenant

#Import DXF
Import DXF = Importer un DXF
Apply Unit = Appliquer l'unité
Convert circle to HOLE on BoardOutLine layer = Convertir les cercles en trou sur la couche BoardOutLine
No shapes found = Aucune forme trouvée
Fail to load the file = Échec du chargement du fichier
Please select a DXF file. = Veuillez sélectionner un fichier DXF.
This feature only works for PCB document. = Cette fonction ne fonctionne que pour le document PCB.
Select a DXF file = Sélectionnez un fichier DXF

#Export DXF
Export DXF = Exporter en DXF
Plated-Through-Hole Pads = 
Non-Plated-Through-Hole Pads =
Silkscreen = Sérigraphie
Surface Pad = Pastille en surface

#Data Sync
Data Sync = Synchronisation des données
Data Conflicts = Conflits de données
Project or Document = Projet ou document
Cloud-Side = Côté Serveur
Local-Side = Côté Client
Decision = Décision
Modified = Modifié
Deleted = Supprimé
As Cloud = 
As Local =
Skip = Passer
Data sync completed = Synchronisation des données terminée

#Team
Team = Équipe
Teams = Équipes
Switching team = Changer d'équipe
Switch team failed = Echec du chamgement d'équipe
Load team info fail! = Échec du chargement des infos sur l'équipe !
Load team info fail! Please reload. = Echec du chargement des infos sur l'équipe ! Veuillez recharger.
My Teams = Mes équipes
Create Team = Créer une équipe

#Dialog Footprint Manager
Footprint Manager = Gestionnaire d'empreinte
Open Footprint Manager = Ouvrir le gestionnaire d'empreinte
Schematic Components =
Edit Pin Map Information =
Package Categories = Catégories de boitiers
Components List = Liste des composants
Personal = Personnel
Component PIN information =
Footprint PAD information =
Footprint Categories = Catégories d'empreintes
Pad Number = Numéro de pastille
Search Footprint = Recherche une empreinte
Filter by keyword = Filtrer par mot-clé
System Libs = Librairies système

#dialog global delete
Drawings =
Netlabel and netFlag =
Texts = Textes
Wires = Fils
Board outlines =
Footprints = Empreintes
Footprint = Empreinte
Tracks = Pistes

#dialog board outline settings
Current Size = Dimension actuelle
Paramenters =
Start X: = Début X:
Start Y: = Début Y:
Round Rectangular = Rectangle avec coin arrondi
radius = rayon
only number is allowed! = uniquement un nombre est autorisé
please input valid value of width! = veuillez saisir une valeur de largeur valide!
please input valid value of height! = veuillez saisir une valeur de la hauteur valide!
please input valid value of radius! = veuillez saisir une valeur de rayon valide!

#cross probe
The object you selected was not found in other documents. =
No valid object for cross probe selected. =
Can not probe. Refreshing the window may get it to work. =
You need to login for this function to work. =

#About Dialog
An Easier EDA Experience = Une expérience EDA plus facile
Version = Version
BuiltDate = Date de construction

#Auto Router Dialog
Auto Router Config = Configuration du routeur automatique
General Options = Options générales
All Layers = Toutes les couches
Configure = Configurer 
Sorry, your web browser does not support this feature. Please run a modern browser. = Désolé, votre navigateur Web ne prend pas en charge cette fonctionnalité. Veuillez utiliser un navigateur récent.
Please make sure all objects with net are inside the board outline! =
Cannot start again before previous activity is stopped =
Please select a net =
TrackWidth cannot be empty =
Clearance cannot be empty =
Router is time out. = Le routeur est hors service.
Server is busy, please try again later. = Le serveur est occupé, veuillez réessayer plus tard.
Due to the limitation of {0}router server{1} resources, multiple routers executing concurrently are not supported, please try again later or do it manually :-) =
Track Width is invalid = La largeur de piste n'est pas valide
General Clearance is invalid =
SMD Clearance is invalid =
Diameter is invalid = Le diamètre n'est pas valide
Drill Diameter is invalid = Le diamètre du foret n'est pas valide
Track width cannot be less than Design Rule Checking (DRC) setting value. =
General Clearance cannot be less than Design Rule Checking (DRC) setting value. =
SMD Clearance cannot be less than Design Rule Checking (DRC) setting value. =
Hole size cannot be less than Design Rule Checking (DRC) setting value. =
Design Rule's via diameter must be larger than via drill diameter =
Clearance cannot be less than Design Rule Checking (DRC) setting value. =
Not a valid PCB, please check it again = Le PCB n'est pas valide, veuillez le vérifier à nouveau.
Previous connection must be closed = La connexion précédente doit être fermée
Network error. Please try again. = Erreur de connexion au réseau. Veuillez réessayer.
Router error. = Erreur du routeur.
Invalid PCB. = PCB invalide.
General Clearance = Espace de dégagement global
SMD Clearance =
#Ripup Nets
Skip Routed Nets =
Remove Existing Tracks =
Real-time Display =
Router Layers =
Via = Via
Special =
Special Nets =
Skip Nets =
Router Server =
Local = Local
Cloud = Cloud
Available = Disponible
Unavailable = Indisponible
Checking = En cours de vérification
Install Local Auto Router = Installer le routeur automatique local
Checking local auto router server... =
Stop Router = Arrêter le routeur
Auto Router is running... = Le routeur automatique est en fonctionnement...

#Left Sidebar
EELib =
Basic =
Extend =
Design Manager = Gestionnaire de Projets
Library = Librarie
Spice Library = Librarie Spice
Shared = Partagé
LCSC =
LCSC Parts = Composants LCSC
Supply Flag =
US =
EU/IEC =
US Style =
Resistor = Résistance
Capacitor = condensateur
Inductor = Inductance
Switch/Key =
EU/IEC Style =
CN =
Connector = Connecteur
Switch/Relay =Interrupteur/Relais
JLCPCB =
Recycle Bin = Corbeille

# Protractor
Font Height = Hauteur de la police
Precision = Précision 
Protractor = Rapporteur

#attr-pcbtext-line-width
Only default font family supports to change font width. = Seule la famille de polices par défaut permet de modifier la largeur de la police.
Font is missing! You can confirm the dialog and use default font instead or cancel the dialog then upload your font and do it again. = La police est absente ! Vous pouvez confirmer la boîte de dialogue et utiliser la police par défaut à la place ou annuler la boîte de dialogue, puis télécharger votre police et recommencer.

#Common
Owner = Propriétaire
License = License
Part Pins = Broches du composant
Net Pins = 
Net Ratlines =
Add Parameter = Ajouter un paramètre
Histories record =
Create Team = Créer une équipe
Can't find this footprint on the server, please re-associate it. = Impossible de trouver cette empreinte sur le serveur, veuillez la réassocier.
The footprint name associated with the component and the footprint name on the server are inconsistent, please re-associate it. = Le nom de l'empreinte associé au composant et le nom de l'empreinte sur le serveur sont incohérents, veuillez le réassocier.
The symbol pin number(s) of the component does not match the associated footprint pad number(s), please modify the symbol pin number(s) or re-associate the footprint = Le(s) numéro(s) de broche du symbole du composant ne correspond(ent) pas au(x) numéro(s) de pastille de l'empreinte associée, veuillez modifier le(s) numéro(s) de broche du symbole ou ré-associer l'empreinte.
No footprint, please associate the footprint first. = Pas d'empreinte, veuillez associer l'empreinte d'abord.
Can't find the package = Le boitier est introuvable.
The path is for the project URL identify, it is unique (the identity of the project owned by the user cannot be the same) = Le chemin est pour l'identification de l'URL du projet, il est unique (l'identité du projet appartenant à l'utilisateur ne peut pas être la même)
It's with a letter or a number and can contain only numbers, letters, line-through, underscores, and points. It cannot be modified after saving. = Il s'agit d'une lettre ou d'un chiffre et il ne peut contenir que des chiffres, des lettres, des traits d'union, des traits de soulignement et des points. Il ne peut pas être modifié après avoir été enregistré.
Updating document to new format, please wait......After finishing please save your document with Ctrl + S. = Mise à jour du document au nouveau format, veuillez patienter......Après avoir terminé, veuillez sauvegarder votre document avec Ctrl + S.
Open at current project? = Ouvrir en tant que projet en cours ?
Please select a history to recover. = Veuillez sélectionner un historique à récupérer.
Be careful! When you click the "Recover" button, this sheet will be overwritten! = Attention ! Lorsque vous cliquez sur le bouton "Récupérer", cette feuille sera écrasée !
Recover = Récupérer
There is no PCB under this project, would you like to create one? = Il n'y a pas de PCB sous ce projet, voulez-vous en créer un ?
Please make sure that the chose Altium Designer files are saved as ASCII files. = Veuillez vous assurer que les fichiers d'Altium Designer choisis sont enregistrés en tant que fichiers ASCII.
Export to Altium function is currently in beta: = La fonction d'exportation vers Altium est actuellement en version bêta :
1. Please be sure to read the notice before exporting: = 1. Veillez à lire la notice avant d'exporter :
Export Altium notice and disclaimer = Avis et clause de non-responsabilité concernant l'exportation d'Altium
2. Please be sure to check again after export! = 2. Veuillez vérifier à nouveau après l'exportation ! 
I have read and agree = J'ai lu et j'accepte
Export to Altium = Exporter vers Altium
Please make sure that the chose Eagle files are saved in Eagle v6.0 and above. = Veuillez vous assurer que les fichiers Eagle choisis sont enregistrés dans Eagle v6.0 et plus.
Please make sure that the Kicad files were compressed as the .zip file. = Veuillez vous assurer que les fichiers Kicad ont été compressés en tant que fichier .zip.
Open Altium Designer file = Ouvrir le fichier d'Altium Designer
The more information please refer at : = Pour plus d'informations, veuillez consulter le site :
Please use Gerber file instead of exporting Altium if you are going to do PCB manufacturing. All PCB factories support the Gerber file. Is it ok to Generate the Gerber file? = Veuillez utiliser le fichier Gerber au lieu d'exporter Altium si vous comptez fabriquer des PCB. Toutes les usines de fabrication de PCB prennent en charge le fichier Gerber. Acceptez-vous de générer le fichier Gerber ?
Yes, Generate Gerber = Oui, générer le Gerber
No, Export Altium = Non, Exporter vers Altium
Open Eagle file = Ouvrir le fichier Eagle
Open Kicad file = Ouvrir le fichier Kicad
Select file(s) = Sélectionner le(s) fichier(s)
Append to current project? = Ajouter au projet actuel ?
Append = Ajouter
Open as new project = Ouvrir comme nouveau projet
Tip: Press {0}SPACE{1} or {2}R{3} to rotate the placing object or selected object. =
Hotkeys Setting = Conseil : Appuyez sur {0}ESPACE{1} ou {2}R{3} pour faire pivoter l'objet placé ou l'objet sélectionné.
I know. Don't show this again. = Je sais. Ne plus le remontrer.
Manufacturer Part Number can not be less than 2 characters. = Le référence du composant du fabricant ne doit pas comporter moins de 2 caractères.
This prefix was changed to non-subpart format. =
Save as New Project = Enregistrer comme nouveau projet
Save to Existing Project = Enregistrer dans le projet existant
Sheet Setting = Sheet Setting
Sheet Size = Taille de la feuille
Pre =
pre =
Invalid Data = Données incorrectes
Others = Autres
You are not authorized to share this project. = Vous n'êtes pas autorisé à partager ce projet.
This project is private: if you continue sharing it will be made public. = Ce projet est privé : si vous continuez à le partager, il sera rendu public.
Modify file info = Modifier les informations du fichier 
Please input search keyword = Veuillez saisir le mot clé de recherche
Sort Projects by = Trier les projets par 
Date Created = Date de création
Date Modified = Date de modification
Title = Titre
Ascending = Croissant
Descending = Décroissant
Pin to Top = Épingler en haut
Unpin from Top = Déspingler en haut
Collapse / Expand = Réduire / Développer
Expand =  Développer
Collapse = Réduire
Expand All = Tout développer
Collapse All = Tout réduire
Your file hasn't been saved, do you want to save it? = Votre fichier n'a pas été enregistré, voulez-vous l'enregistrer ?
Don't Save = Ne pas enregistrer
Library Owner: = Propriétaire de la bibliothèque :
verifyPkg.Value =
State = État
Please select! = Veuillez sélectionner !
Route =
Import successfully: = Importation réussie :
Import failed: = L'importation a échoué :
The title length must be between 2~128 characters. = La longueur du titre doit être comprise entre 2 et 128 caractères.
Path only contain 'a-z、A-Z、- 、 _ 、0-9'! = Le chemin contient seulement 'a-z、A-Z、- 、 _ 、0-9'!
Path must begin as 'a-z、A-Z、0-9'! = Le chemin doit commencer par 'a-z、A-Z、0-9'!
The path length must be between 4~128 characters! = La longueur du chemin doit être comprise entre 4~128 caractères !
The title length must be between 2~256 characters! = La longueur du titre doit être comprise entre 2~256 caractères !
The title cannot be less than 3 characters! = Le titre ne peut pas comporter moins de 3 caractères !
Do you want to delete this file? = Voulez-vous supprimer ce fichier ?
Add sub part success = Ajout du sous-composant avec succès
Please input name and prefix! = Veuillez saisir le nom et le préfixe !
Board outlines are not closed = Les contours de la carte ne sont pas fermés
Import Altium file fail, the file needs to be an ASCII file encoded in UTF-8. = L'importation d'un fichier Altium a échoué, le fichier doit être un fichier ASCII codé en UTF-8.
The Pins "{0}" are not snapped on the grid point! This part maybe will cause some errors in the schematic. = Les broches "{0}" ne sont pas fixées sur un point de la grille ! Ce composant peut provoquer des erreurs dans le schéma.
Check Pin = Vérification de la broche
Failed to read {0} = Impossible de lire {0}
{0} is invalid = {0} n'est pas valide 
{0} not found = {0} non trouvé
Failed to execute script: = Échec de l'exécution du script :
One or more js files not found = Un ou plusieurs fichiers js n'ont pas été trouvés
Only ONE {0} file is required = Un seul fichier {0} est nécessaire
Extension ID is required = L'ID d'extension est requis
Extension ID is invalid = L'ID d'extension est invalide
Extension ID is duplicated = L'ID de l'extension est dupliqué
No Result! = Aucun résultat !
Load Error = Erreur de chargement
loading = chargement
Failed to load spice data = Impossible de charger les données de spice.
Netlist = Netlist
Tags =
Pin Information: = Informations sur la broche : 
Format incorrect, please check for the extra spaces or commas! = Le format est incorrect, veuillez vérifier les espaces ou les virgules supplémentaires !
Round Radius = Rayon de courbure
Keyword: = Mot clé:
Image = Image
Image copied. = Image copiée
Copy failed. = Echec de la copie
Copy success. = Copie réussie.
Image Property = Propriété de l'image
Locked = Bloqué
Unlock All = Tout débloquer
Unlock = Débloquer
Lock = Bloquer
Please input pin name and pin number! = Veuillez saisir le nom et le numéro de la broche !
Left-Hand Panel = Panneau latéral de gauche
Right-Hand Panel = Panneau latéral de droite
Update All = Tout mettre à jour
The pin number(s) can't find the same pad number(s) =
Designator =
Replace = Remplacer
Update failed = La mise à jour a échoué
Successfully updated = Mise à jour réussie
Update failed! = La mise à jour a échoué !
Successfully updated! = Mise à jour réussie !
Successfully updated {0} component(s)! = Mise à jour réussie de {0} composant(s)!
Change = Changer
Check Footprints = Vérifier les empreintes
Network Error! = Erreur de connexion !
Find Similar Objects = Trouver des objets similaires
Current Sheet = Feuille actuelle
All Sheets = Toutes les feuilles
Kind =
Range = Plage
Net Label/Net Flag/Net Port/Voltage Probe =
Bezier/Freehand Draw =
Arc/Pie = Arc/Tarte
Objects Properties = Propriétés des objets
Any = Tout
Same = Pareil
Different = Différent
Circular = Circulaire
Expose Copper = Exposer le cuivre
"{0}" font is missing. Please add the font to the font family list. = La police "{0}" est manquante. Veuillez ajouter la police à la liste des familles de polices.
Place Component = Placer le composant
Delete Segment = Supprimer le segment 
Angle = Angle
Board Thickness = Epaisseur de la carte
Layer Distance = 
Silk Screen = Sérigraphie
Surface Finish Color = Couleur de la finition de surface
Colors = Couleur
Board Color = Couleur de la carte
Board Side = Face de la carte
Silk Screen = Sérigraphie
Silk Screen Color = Couleur de la sérigraphie
Display = Afficher

# Array and Clone
Distribute Array =
Array Type = 
Matrix Array =
Circular Array =
Item Rotation =
Location = Emplacement
Items per Column = Éléments par colonne
Items per Row = Éléments par ligne
# Column Spacing
# Row Spacing
Spacing(Degrees) = Espacement (degrés)
Start Degree = 
Rotate Item to Match =
Clockwise = Sens des aiguilles d'une montre
Anti-Clockwise = Sens inverse des aiguilles d'une montre
Distribute by =
Column = Colonne
Row = Ligne
Array Clone =
Number of Rows = Nombre de lignes
Number of Columns = Nombre de colonnes
Number of Copies = Nombre de copies
Distribute Range(Degrees) =

# Theme color dialog
BusEntry = Entrée de Bus
Foreground = Premier plan
Common Used = Utilisé couramment
Original Theme = Thème original
Theme Setting = Réglage du thème
Change the theme colors of your design = Modifier les couleurs du thème de votre conception
White on Black = Blanc sur noir 
Black on White = Noir sur blanc
Custom Theme = Thème personnalisé
Color Setting = Réglage de la couleur
Apply Setting = Appliquer le paramètre
Theme Setting... = Réglage du thème...
Bus Entry = Entrée de Bus
Foreground = Premier plan
Symbol Graphics =
Common Used = Utilisé couramment
Draw =
Sheet = Feuille
The original theme only works for placing the new symbols. = Le thème original ne fonctionne que pour placer les nouveaux symboles.
Selection Highlight =
Net Label / Port =

My Theme = Mon thème
My Theme Settings = My Theme Settings
Apply 'Custom Theme' On = Appliquer le "thème personnalisé" sur
Creating New Schematic = Création d'un nouveau schéma
Opening Existed Schematic = Ouvrir un schéma existant
Please fill in all parameters! = Veuillez remplir tous les paramètres !
Convert to Board Cutout =
Prefix Position = Emplacement du préfixe
Name Position = Emplacement du Nom
Center = Centre
Top = Haut
Bottom = Bas
Left = Gauche
Right = Droite
Does not support multiple objects to convert to Board Cutout at the same time =
Does not support multiple objects to convert to pad at the same time =
Convert to Board Cutout =
Convert to Pad = Convertir en pastille
Convert to Component Shape =
Combine to Continuous Track =
Convert to Solid Region = Convertir en région solide
Substrate =
3D View = Vue 3D
2D View = Vue 2D
Pin Color = Couleur de la broche
Name Color = Nom de la couleur
Number Color = Numéro de la couleur
Dot = Point

[theme]
Sheet = Feuille
[/theme]


#history dialog
[history-dlg]
Number = Nombre
Editor = Editeur
[/history-dlg]
View File History = Afficher l'historique des fichiers
Save Time = Gagner du temps

Invalid Format = Format non valide

#Dialog Teardrop
Round Pad / Via = Pastille / Via arrondi
Rectangle / Oval / Polygon Pad =
Applying Teardrops =
Removing Teardrops =
Waiting = En attente
Progressing... = En cours...

No schematic in the project! = Pas de schéma dans le projet !

Move Forward = Avancer
Move Backward = Reculer

#Dialog Panelize
V-CUT =
Stamp Hole =
No Panelize = Pas de panélisation
Border and Marking =
Create Border = Créer une bordure
Border Height = Hauteur de la bordure 
Border Position = Position de la bordure
Create Positioning Holes =
Create Fiducial Marks =
Top and Bottom = Haut et bas
Left and Right = Gauche et droite
Stamp Hole Group - Column =
Stamp Hole Group - Row =
The number of rows and columns cannot be set to 1 simultaneously = Le nombre de lignes et de colonnes ne peut pas être fixé à 1 simultanément.

#edit path point
[editPathPoints-dlg]
Arc(R) = Arc(R)
Type = Type
Action = Action
add before = ajouter avant
add after = ajouter après
delete = supprimer
[/editPathPoints-dlg]

#edit polygon point
[editPolygonPoints-dlg]
Action = Action
add before = ajouter avant
add after =  ajouter après
delete = supprimer
[/editPolygonPoints-dlg]
You have unconfirmed edit! = Vous avez une modification non confirmée !
Invalid edit! = Modification invalide !

#Dialog PCB Information
PCB Information... = Information sur le PCB
Signal Layers = Couches de signaux
None Signal Layers = Couches sans signaux
Pads = Pastilles
Surface Pads =
Plated Through-hole Pads =
None Plated Through-hole Pads =
Holes = Trous
Vias = Vias
Length of Tracks = Longueur des pistes
Copper Areas = Zones de cuivre

#Differential Pair Routing
Differential Pair Routing = Routage des paires différentielles
Differential Pair Rule Setting = Réglage de la règle pour les paires différentielles
Please input track width = Veuillez indiquer la largeur de la piste 
Please input clearance = Veuillez saisir l'espace de dégagement
Routing Rules = Règles de routage

#Route Length Tuning
Track Length Tuning... =
Tracks with different net or non-track found in current targets. =
Please select the signal tracks to be tuning. =
The total length exceeds the Design Rule Checking (DRC) constraint, continue ? =
45° Angle =
90° Angle =
DRC Track Length : =
Current Length : =
Additional Length : =
Target Length: =
Current Length: =

can not connect to the server = ne peut pas se connecter au serveur

#Dialog Copper Area Manager
Copper Area Manager... =
Copper Area Manager =
Order =
Name = Nom
Layer = Couche
Color = Couleur
Net = Connexion
Move Up = Monter
Move Down = Descendre
Apply = Appliquer
Cancel = Annuler
Copper Area do not allow self-intersection! =
No copper area! =
#Dialog report error
Datasheet = Fiche technique
Verification =
Symbol =
Pad Number =
Pad Size =
Remark =
Correct =
Incorrect =
Submit = Soumettre
Tip = Astuce
Please select one component = Veuillez choisir un composant
Location X = Emplacement X
Location Y = Emplacement Y
Your current browser version may not support some features. Please use the latest version of Chrome or Firefox, or try the desktop client. = La version actuelle de votre navigateur peut ne pas prendre en charge certaines fonctionnalités. Veuillez utiliser la dernière version de Chrome ou Firefox, ou essayer le client de bureau.
EasyEDA Client =
LCEDA Client =
Chrome =
FireFox =
New Version = Nouvelle version
Switch Version = Changer de version
Members = Membres
Update Time =
Editor = Editeur
Current Version: = Version actuelle :
Select a version to switch =
3D Model = Modèle 3D
Board Side =
Display =
Copper = Cuivre
Create New Version = Créer une nouvelle version
Create new version success! =
Version Management =
Switch success! =
Please close current version's documents first! =
Creator =
Create Time =
Fail to connect to server! Please check your internet connection status and try again! =
Spice Number =
Create =
3D Outline =
Cannot create the slot hole via the board outline, please use the following methods: =
Use the solid region and set its type as Board Cutout =
Select a Track/Arc, right-click to use the "Convert to Board Cutout" =
Select all the closed Tracks/Arcs, right-click to use the "Convert to Board Cutout" =
The more information please refer at =
Save "{0}" success! =
Save "{0}" failed! =
Invalid Size =
Processing =
Invalid Size =
NetFlag GND = Drapeau Piste Gnd
NetFlag VCC = Drapeau Piste Vcc
NetFlag +5v = Drapeau Piste +5V
No Useful Data! =
SVG Preview =
Prefix contains not supported charater(s) ! =
Name contains not supported charater(s) ! =
Create Grid Path =
Please Input Name =
Building Copper Area =
Processing =
Opening File =
Update from Library =
Update Footprint =
Find footprint(s) have been updated, do you want to update? =
3D File: =
Model List =
Are you sure merge net {0} and net {1}? =
Display Footprint =
Display Footprint Name While Placing Component =
Annotate Prefix Automatically After Placing Component =
Program Error, Please Contact Technical Support! =
Search Engine =
Keyword to Filter =
Normal Mode =
Expand Mode =
3D Model Manager =
3D Model Preview =
3D Model =
3DModel =
Document = Document

[pcblayer]
3DModel = Modèle 3D
Document = Document
[/pcblayer]

Adjustment =
View Larger Image =
Previous = Précédent
Previous Image = Image précédente
Next Image = Image suivante
Notice: For reference only, please refer to the real product = Avis : Pour référence uniquement, veuillez vous référer au produit réel.
It's under designing, please wait. = Il est en cours de conception, veuillez patienter. 
The width of track/arc/circle cannot be less than 0.1mil! =
Clone success ! = Clonage réussi !
Footprint Naming Reference =
3D Model Manager = Gestionnaire de modèles 3D
Will jump to the Lichuang open source hardware platform (OSHWHub.com) to improve the information and share. Whether to continue? =
Will jump to the EasyEDA open source hardware platform (OSHWLab.com) to improve the information and share. Whether to continue? =
The project content page will open. After adding a description and setting the project to public, you can click the share button to get the share link. =
This project is not public, can not view homepage! = Ce projet n'est pas public, on ne peut pas voir la page d'accueil !

[grid]
None = Aucun
[/grid]

#lib verify and mounted
This component is verified = Ce composant est vérifié
This component is unmounted =

#find component
Find Next = Trouver le suivant
Object not found = Objet non trouvé

#offset Elements
Offset X = Décalage X
Offset Y = Décalage Y
Offset = Décalage
Absolute Offset = Décalage absolu
Relative Offset = Décalage relatif
Absolute Offset... = Décalage absolu...
Relative Offset... = Décalage relatif...
Reference Point X = Point de référence X
Reference Point Y = Point de référence Y

# Inner Plane layer
Rebuild Plane = Rebuild Plane 
PlaneZone Properties =
Change to a plane layer is not allowed during track routing. = Le passage à une couche plane n'est pas autorisé pendant le routage des pistes.
#pcblib rect
Fill = Remplir
Fill Type = Type de remplissage
[PlaneZone]
Solid = Solide
[/PlaneZone]

Solid Region do not allow self-intersection! = Les régions solides ne permettent pas l'auto-intersection !

The prefix or name or text too far away from the footprint, if you don't want it to show up please make it hidden. = Le préfixe, le nom ou le texte est trop éloigné de l'empreinte, si vous ne voulez pas qu'il apparaisse, veuillez le masquer.
The prefixes are not allowed to repeat! = Les préfixes ne sont pas autorisés à se répéter !
Save failed! The origin of the canvas is not in the graphics! Whether to set the origin automatically? = La sauvegarde a échoué ! L'origine de la toile n'est pas dans les graphiques ! Faut-il définir l'origine automatiquement ?
The origin of the canvas has been set in the graphics now, you can save again. =
Backup Project =
Open Project Directory = 

{0} items updated = {0} éléments mis à jour

The current file {0} has an updated version. Do you want to overwrite it? If you want to open the latest version, please close the current file and reopen it. = Le fichier actuel {0} a une version mise à jour. Voulez-vous l'écraser ? Si vous voulez ouvrir la dernière version, veuillez fermer le fichier actuel et le rouvrir.
Yes, Overwrite It = Oui, écrasez-le
No, Keep It = Non, gardez-le.

Download Client = Client de téléchargement

Search tutorial、open source projects etc. = Recherche de tutoriels、projets open source, etc.

Go to LCSC and search for = Allez sur LCSC et cherchez
Go to LCSC = Allez sur LCSC

Hide Ratline Layer and Keep the Component Prefix When Paste Objects =

ALL.layer = Tout les calques
Copper.layer =
Non-Copper.layer =
Other.layer =

Please enter at least 2 characters! = Veuillez saisir au moins 2 caractères !
View Datasheet = Voir la fiche technique
View Datasheet... = Voir la fiche technique... 

The corresponding package or network could not be found in the currently open PCB document =
delete fail =

[crashRecovery]
Libraries = Libraries
[/crashRecovery]
Canvas origin anomaly! =

Component's Name = Nom du composant
Component's Prefix = Préfixe du composant
Component's Footprint = Empreinte du composant

[findlib]
Clear = Effacer
Apply Filters = Appliquer les filtres
Result = Résultat
Place = Placer
Prev = Précédent
Next = Suivant
Total {count} Count =
About = A Propos de
Items = Objets
[/findlib]

Object = Objet
Layers and Objects =
All = Tous

Add custom = Ajoutez des éléments personnalisés

Connections =
Attempted: =
Completed: =
Failed: =
Total Vias: =

Please confirm moving option = Veuillez confirmer l'option de transfert
Only this pad = Seulement cette pastille
For this component = Pour ce composant
View Owner = Voir le propriétaire
View Detail = Voir détail


# place batch vias
Place Vias = Placer les vias
Placing Vias = Placer les vias
Removing Vias = Enlever les vias
Batch Vias for Copper =
Add/Remove Vias = Ajouter/Enlever Vias
Diameter = Diamètre
Drill Diameter = Diamètre du foret
Column Spacing = Espacement des colonnes
Row Spacing = Espacement des lignes
Multiple vias have been placed, do you want to rebuild the copper area? = De multiples vias ont été placés, voulez-vous reconstruire la zone de cuivre ?
Remove vias finish, do you want to rebuild the copper area? = Ls vias ont étés enlevés,  voulez-vous reconstruire la zone de cuivre ?
The width of track/arc/circle cannot be less than 0.051mm/2mil/0.002inch! =
Save fail! Please try again! = Echec de l'enregistrement. Veuillez réessayer !
Please select a copper outline =
Can't find copper area at other layers, please add the copper area with the same net at other layer first. =

Add favorite success! = Ajouté aux favoris avec succès
Remove favorite success! = Retiré des favoris avec succès
Remove favorite failed! = 
Whether if remove favorite? =
Split by ';' for multi tags =

This size is the determined size! = Cette taille est la taille déterminée !
The associated pad has been locked = La pastille associée a été verrouillée.
Split by space or , for multi tags =

Rotation X =
Rotation Y =
Rotation Z =

Some fields are filled invalid data = Certains champs sont remplis de données invalides
start time should be earlier than stop time = l'heure de début doit être avant l'heure de fin
Number of points should be less than 100 in octave variation =
Start frequency should be less than stop frequency. The suffix meg stands for Mega,m stands for milli =
Get historical records fail! =
This 3D model didn't create the outlines successfully, please import it again or contact with us. =
There is No Tag! =
Assign successful! =
Found footprint's pad number doesn't match the schematic component's pin number, please correct the pad number and try again! =
Update Property =
Please fill in at least 5 words. =
Mouse hovering over the track to highlight the entire network =
Net Highlighting While Cursor Hover the Track =
When circle set as "Yes", the Pin length must be more than 6 =
Hi, I found a problem of your library, this library seems incorrect.\ntitle:{title}\nType:{type}\nlink:{link}\n{content}\nThank you! =

Logout fail! Please try again! = Échec de la déconnexion ! Veuillez réessayer !
Logout success! We look forward you to use LCEDA again! = Déconnexion réussie ! Nous espérons que vous utiliserez à nouveau LCEDA !
Logout success! We look forward you to use EasyEDA again! = Déconnexion réussie ! Nous espérons que vous utiliserez à nouveau EasyEDA ! 
Click to Preview 3D = Cliquez pour visualiser la 3D
[logoutDialog]
Logout = Déconnexion
[/logoutDialog]

[findlibTag]
All = Tous
[/findlibTag]

Export Pick and Place File = Exportation du fichier Pick and Place
Mirror the bottom component's X coordinate (JLCPCB doesn't need) =
Work Space = Espace de travail
Include panelized components' coordinates =
Personal Workspace = Espace de travail personnel
Work Space - {name} =
Work Space - Personal =
Cloning = Clonage

Project Owner = Propriétaire du projet
Clone Project = Cloner le projet
Homepage = Page d'acceuil
Apply for Education Edition = Demandez l'édition Éducation
Load Organization failed =
Joined =
Favorite =
This operation will unfavorite this project, do you want to continue? =
View Homepage = Voir la page d'accueil
Private Project = Projet Privé
3-7 days = 3 à 7 jours 
Close Tab = Fermer l'onglet
Close Other Tabs = Fermer les autres onglets
Close All Tabs = Fermer tous les onglets
Open in New Window = Ouvrir dans une nouvelle fenêtre
Cursor Snap to Component's Origin or Pad Center While Dragging Component =
Undefined = Indéfini
Input = Entrée
Model Unit = Unité du modèle 
File Unit = Unité du fichier
This part contains subparts, please make sure you have checked other subparts before reporting error, do you want to continue? =

[saveAs]
Power = 
[/saveAs]

Assign LCSC Part# =
Unexpected error while converting. Perhaps unsupported file type or program bug. =
Found duplicated component IDs, please click "OK" to re-assign component ID automatically, and then save the document and try again. =

#electromagneticSimulation
Electromagnetic Simulation... =
You will upload Gerber to SuperEM for electromagnetic simulation (only upload Gerber, not including account data), do you want to continue? =
SuperEM is a 3-D full-wave electromagnetic simulation and design platform for high-speed PCB circuits and antennas, which is developed by Faraday Dynamics, Ltd. =
Visit the SuperEM =
SuperEM User Guide =
Upload Gerber to SuperEM successfully, please click "OK" buttun to continue =

Format =
View = Vues
Design =
Simulation =
Advanced =
Fabrication =
Check DRC =
Simulation Setting =
BOM = Nommenclature
PCB Fabrication File(Gerber) =
Pick and Place File =
Parts Order =
PCB Order =
SIM =
STD =
WaveForm = Courbe

Place Module =
Please enter identification letters: =
Only support English letters, up to 5. =

Exist doesn't annotate prefix component(s) in the module, please edit and annotate the unique prefix(s) for component(s) first. =
Opening =

Also update track's net (Only applies to circumstance under which prefix/netlabel changes and no component/wire is added or removed) =

# desktop client error feedback
Cannot open online documents on Project Offline mode. =

Please select a project = Veuillez sélectionner un projet 
Opened Projects = Projets ouverts
Open Project = Projet ouvert
Close Project = Fermer le projet
Open All Projects = Ouvrir tous les projets
Close All Projects = Fermer tous les projets
Select Owner = Sélectionner le propriétaire
Select Folder = Sélectionner le dossier
Select Owner or Folder = Sélectionner le propriétaire ou le dossier
Select Project = Sélectionner le projet
Folder = Dossier
New Folder = Nouveau dossier
New Sub Folder = Nouveau sous-dossier
Delete Folder = Supprimer le dossier
Move Project = Déplacer le projet
Move Folder = Déplacer le dossier
# Rename Folder =
Please input the folder name = Veuillez saisir le nom du dossier
Invalid folder name = Nom de dossier non valide
Are you sure to delete this folder? = Etes-vous sûr de vouloir supprimer ce dossier ?
Create new folder successfully = Nouveau dossier créé avec succès
Failed to create new folder = Échec de la création d'un nouveau dossier
Delete folder successfully = Suppression du dossier avec succès
Failed to delete folder = Échec de la suppression du dossier
Rename folder successfully = Dossier renommé avec succès
Failed to rename folder = Échec du renommage du dossier
Move folder successfully = Dossier déplacé avec succès
Failed to move folder = Échec du déplacement du dossier
Move project successfully = Projet déplacé avec succès
Failed to move project = Impossible de déplacer le projet
The folder depth must not exceed {0} levels = La profondeur du dossier ne doit pas dépasser {0} niveaux.
Failed to add project to folder = Impossible d'ajouter le projet au dossier

Doesn't support JLCPCB SMT Service = Ne supporte pas le service CMS de JLCPCB
{0} for JLCPCB SMT Service = {0} pour le Service Comments de JLCPCB

Reset failed! There are duplicate component prefixes in the current schematic: = La réinitialisation a échoué ! Il y a des préfixes de composants en double dans le schéma actuel :
Reset failed! There are duplicate component prefixes in the current PCB: = La réinitialisation a échoué ! Il y a des préfixes de composants en double dans le PCB actuel :
Please modify the component prefixes first to ensure that the component prefix is unique. = Veuillez d'abord modifier les préfixes des composants afin de vous assurer que le préfixe du composant est unique. 

LCEDA(Standard) - A Simple and Powerful Electronic Circuit Design Tool = LCEDA(Standard) - Un outil de conception de circuits électroniques simple et puissant
EasyEDA(Standard) - A Simple and Powerful Electronic Circuit Design Tool = EasyEDA(Standard) - Un outil de conception de circuits électroniques simple et puissant

#Dialog for Package Custom Data
Please input the data title = Veuillez saisir le titre des données
Data title duplicated = Titre des données dupliqué 
Cannot be more than {0} characters! = Il ne peut y avoir plus de {0} caractères !
Only latin alphabets, digits, underscore(_) and hyphen(-) are allowed. =
Invalid value of item {0} = Valeur non valide de l'élément {0}
Update DFM =
Custom DFM Data =
Saved custom data successfully! = Sauvegarde des données personnalisées avec succès !
Save custom data failed! = La sauvegarde des données personnalisées a échoué !
Will replace the graphics and custom data of current document, after imported please adjust the 3D model. Continue or not? = Remplacera les graphiques et les données personnalisées du document actuel, après l'importation, veuillez ajuster le modèle 3D. Continuer ou non ?
Open footprint "Custom Data" dialog = Open footprint "Custom Data" dialog

# Create lead shape
Create Lead Shape =
Base on Pad Center =
Base on Canvas Origin =
Lead shape =
Footprint Type =
From pad shape =
Lead length =
Lead width =
Lead diameter =
Scaling ratio =
Leads creating direction =
Auto =
Horizontal =
Vertical =
Canvas origin to lead edge =
Canvas origin to body edge =
Lead soldering length =
Lead soldering part diameter =
Component shape object doesn't overlap lead shape object, please check carefully. =
The solder mask expansion of pads ({0},{1}) has a small clearance(less than 0.08mm), it will cause the soldering too short, please modify. =
The paste mask expansion or custom paste mask layer objects of pads ({0},{1}) has a small clearance(less than 0.15mm), it will cause the stencil to create fail, please modify. =
System footprint must have pad number 1 or A1, please modify the pad number. =
System footprint doesn't allow two or more pad numbers are 1 or A1, please modify the pad number. =
Document layer has circle object, but jlcPara's polarity is 0, please check the Custom Data. =
There are exist repeat pad numbers: {padNumber}, please check, if it is correct please ignore this. =
Can't find the circle at the component marking layer, or this circle doesn't at the same quadrant with the 1st pad, please check whether it is correct. =

ROUND =
RECTANGLE =
OCTAGONAL =
Upper left = En haut à gauche
Lower left = En bas à gauche
Center of Pads = Centre des pastilles
First Pin = Première broche
Package Name = Nom du boitier
Pins Number = Nombre de broches
Rows Of Pin =
Columns Of Pin =
Polarity = Polarité
Pad Shape =
Body Diameter =
Lead Span =
Lead Vertical Span =
Body Length =
Body Height =
Pin Diameter = Diamètre de la broche
Pin Length = Longueur de la broche
Pin Height = Hauteur de la broche
Pin Solid Width =
Pin Solid Height =
Pin Spacing = Espacement des broches
Pin Horizontal Spacing = Espacement horizontal des broches
Pin Vertical Spacing = Espacement vertical des broches
ThermalPad =
Pad Expansion =
Custom PasteMask =
Fabrication Tolerance =
Placement Tolerance =
FirstPin Position =
Package Origin = Origine du boitier 
Expansion Size =
Corner = Coin
Angle = Angle
Fillet = Filet
Chamfer = Chanfrein
Update Preview = Aperçu de la mise à jour
Number of pins (left and right) = Nombre de broches (gauche et droite)
Number of pins (up and down) = Nombre de broches (haut et bas)
Reference Use Cases = Cas d'utilisation de référence
Package Type = Type de boitier
Capacitance = Capacité
Resistance = Résistance
Bidirectional Diode = Diode bidirectionnelle
Inductance = Inductance
Crystal Oscillator = Oscillateur à quartz
Diode = Diode
LED = DEL
Fuse = Fusible
Entity height =
Lead Overhang =
Lead Thickness =
Unknown mistake =
Has ThermalVias =
Polar Capacitance =

Create Component Marking =
Create component marking successfully! =
No elements on component shape layer! =
No elements on lead shape layer! =
No pad of number 1 or A1, please modify the pad number. =
Save failed! Component marking circle is at the axis. Do you want to recreate the component marking? =
If autoroute fail, you can export the autoroute file(DSN) to third-party autorouter tool(Such as: Konekt Electra, Eremex TopoR etc.), and export the session file(SES) after finished autoroute, and then import to PCB. =
Auto route failed! Found abnormal pad(s) data, please modify the pad width and height: =
Select Properties = Sélectionner les propriétés 
Combine the same parts' prefixes in one row = Combiner les préfixes des mêmes composants sur une seule ligne.
Please check at least one item! = Veuillez cocher au moins un élément !
Pins = Broches
Check component latest version when open schematic = Vérifier la dernière version du composant lors de l'ouverture du schéma
Only show updated components = Afficher uniquement les composants mis à jour
Note: When a PCB is Import Changes, the PCB is updated according to the footprint version to which the schematic is bound. =
Doesn't support to import the binary format DXF, please import the ASCII format DXF. = Ne supporte pas l'importation du format binaire DXF, veuillez importer le format ASCII DXF.

Find System Similar Footprint =
Found similar footprints at system library, it is recommended to use them first. =
Copy Title =
Check system similar footprint =
Can't find the Similar Footprint = Impossible de trouver d'empreintes similaires
Search failed! = La recherche a échoué !
No package information! = Aucune information sur le boitier !
Find Parameters = Trouver des paramètres
Find Results = Trouver des résultats

Bill of material(BOM) uploaded finish, please click "OK" to continue. = Le téléchargement de la nomenclature est terminé, veuillez cliquer sur "OK" pour continuer.
Bill of material(BOM) upload failed! = Le téléchargement de la nomenclature a échoué !

All pads = Toutes les pastilles 
All holes = Tous les trous
Single layer pads = Pastilles à une seule couche
Multi-layer pads = Pastilles multicouches
Same X pads =
Same Y pads =
Same Y and clearance pads =
Same X and clearance pads =
Same X and clearance pads' clearance =
Same Y and clearance pads' clearance =
Pad's hole diameter(max) = Diamètre du trou de la pastille (max)
Pad's hole diameter(min) = Diamètre du trou de la pastille (min)
Pad's hole diameter(aver) = Diamètre du trou de la pastille (moyenne)

Try Pro Edition = Essayez l'édition Pro

Generate Solid Region by Objects Outline =
Generate Polygon Pad by Objects Outline =
Select the objects that cannot be generated = Sélectionnez les objets qui ne peuvent pas être générés

Please compress schematic and PCB as a zip file and then import it, if you only import the schematic you need to binding with the footprint manually. = Veuillez compresser le schéma et le PCB dans un fichier zip, puis importez-les. Si vous importez uniquement le schéma, vous devez lier l'empreinte manuellement. 
Please compress schematic and PCB in ASCII format as a zip file and then import it, if you only import the schematic you need to binding with the footprint manually. = Veuillez compresser le schéma et le PCB au format ASCII dans un fichier zip, puis importez-les. Si vous importez uniquement le schéma, vous devez lier l'empreinte manuellement.
Import failed! The imported files were not ASCII format, please save the files as "Advanced Schematic ascii(*.SchDoc)" or"PCB ASCII File(*.PcbDoc)" at Altium Designer first, and then import. =
The PCB text will use the editor new font family, the text maybe will appear a little excursion. = Le texte du PCB utilisera la nouvelle famille de polices de l'éditeur, le texte apparaîtra peut-être un peu en retrait.
Because of different file format and element, please check carefully after imported. = En raison des différences de format de fichier et d'éléments, veuillez vérifier attentivement après l'importation.
Please make sure the EAGLE file is saved in EAGLE v6.0 and higher version. = Veuillez vous assurer que le fichier EAGLE est enregistré dans la version EAGLE v6.0 et supérieure. 
Please compress schematic and PCB as a zip file by KiCad5 and then import it, if you only import the schematic you need to binding with the footprint manually. = Veuillez compresser le schéma et le PCB dans un fichier zip avec KiCad5, puis importez-les. Si vous importez uniquement le schéma, vous devez lier l'empreinte manuellement.
Please make sure the Protel file is exported as ASCII format file. = Veuillez vous assurer que le fichier Protel est exporté au format ASCII.
Please compress the schematic and corresponding symbols as a zip file and then import it. = Veuillez compresser le schéma et les symboles correspondants dans un fichier zip, puis importez-le.

Please save the files as "Advanced Schematic ascii(*.SchDoc)" or"PCB ASCII File(*.PcbDoc)" at Altium Designer first, and then import. =
Tips = Astuces
Exists incomplete connection = Il existe une connexion incomplète
Found that the board has incomplete connection, please check the nets and ratlines =
creator = créateur
You are not logged in or the login status is invalid, please login and try again. = Vous n'êtes pas connecté ou le statut de connexion est invalide, veuillez vous connecter et réessayer.
Display Board Cutout =
