# Menu
User = Gebruiker
Join... = Lid worden…
Login... = Login...
Log in = Log in
Logout = Log uit
Change password... = Wachtwoord wijzigen…
User Preference = Voorkeursinstellingen
System Settings... = Systeeminstellingen…
System Settings = Systeeminstellingen
Crash = Crash
Invite friends... = Vrienden uitnodigen…
Language = Taal
Language Setting = Taal instellingen
 
Document Recovery = Document aanmaken
Your Preferences Information = Voorkeursinstellingen
File = Bestand
New = Nieuw
Project... = Project
Schematic = Schema
Schematic-Simulation = Schema simulatie
Spice Symbol = Spice symbool
Spice Subckt = Spice (sub)symbool
spicePre = spicePrefix
PCB = PCB
Schematic Module = Schema module
PCB Module = PCB module
Save... = Opslaan…
Save As... = Opslaan als…
Save As Module... = Opslaan als Module
Print = Afdrukken
Export Document = Document exporteren
LTspice... = LTspice…
Eagle... = Eagle…
Altium... = Altium…
Cadence... = Cadence…
Pads... = Pads…
DXF = DXF
Import = Importeren
Edit = Bewerken
Undo = Ongedaan maken
Redo = Opnieuw
Cut = Knippen
Copy = Kopiëren
Paste = Plakken
Select = Selecteren
Delete = Wissen
Clear All = Alles wissen
Move = Verplaatsen
Drag = Slepen
Bring to Front = Naar de voorgrond
Send to Back = Naar de achtergrond
Align = Uitlijnen
Align Left = Links uitlijnen
Align Right = Rechts uitlijnen
Align Top = Boven uitlijnen
Align Bottom = Onder uitlijnen
Align Horizontal Centers = Horizontaal centreren
Align Vertical Centers = Verticaal centreren
Distribute Horizontally = Horizontaal verdelen
Distribute Vertically = Verticaal verdelen
Distribute Left Edges Equidistantly = Linkse kant evenredig verdelen
Distribute Top Edges Equidistantly = Bovenkant evenredig verdelen
Align Grid = Uitlijnen op grid
Rotate = Draaien
Rotate Left = Linksom draaien
Rotate Right = Rechtsom draaien
Flip Horizontal = Horizontaal spiegelen
Flip Vertical = Verticaal spiegelen
Rotate and Flip = Draaien en spiegelen
Group/Ungroup Symbol... = Groeperen/Degroeperen van symbolen
 
[menu_project] 
View = Weergave
[/menu_project] 
Find = Zoekn
Zoom In = Inzoomen
Zoom Out = Uitzoomen
Fit in Window = Passend in venster
Refresh = Verversen
Snap = Fangen
Cross Cursor = Fadenkreuz
Toolbars = Gereedschap
Drawing Tools = Teken gereedschap
Wiring Tools = Bedrading gereedschap
Power Objects = Stroom objecten
PCB Tools = PCB gereedschap
Footprint Tools = Bauteil Grenflächen Werkzeuge
Layers Tool = Lagen gereedschap
Layer Manager = Lagen beheer
Enable and Show All Layers = Aktiviere en zeige alle Lagen
Net Visible = Net weergeven
Auto = Automatisch
Digital Objects = Digitale Objecten
Tools = Gereedschap
Arc Center = Boog uit het midden
Arc Type = Boog soort
Center Point Arc = Middelpunt boog
Two-point Arc = Twee-Ponder boog
 
Place = Plazeren
Drawing Tools = Teken gereedschap
Arc = Boog
Elliptical Arc = Elliptische boog
Ellipse = Ellips
Circle = Cirkel
Pie = Taartstuk
Line = Lijn
Polyline = Poly lijn
Rectangle = Rechthoek
Rectangular = Rechthoekig
The rectangle does not support non-90 degree rotation. Please use Solid Region instead. = Rechthoeck kan niet 90° draaien. Gebruik een 'Solid Region'.
 
Rect = Rechthoek
Round Rectangle = Afgeronde rechthoek
Polygon = Veelhoek
Bezier = Bezier kromme
Path = Pad
Graphic = Grafiek
Bus = Data bus
Bus Entry = Databus ingang
Junction = Verbindingspunt
Net Port = Stroom aansluiting
Voltage Probe = Spanningsmeter
Power Port = Stroom aansluiting
Wire = Draad
Annotation = Opmerking
Track = Leiterbahn
Image = Afbeelding
Arrow Head = Pijl punt
Arrowhead = Pijlpunt
Arrow = Pijl
No Connect Flag = niet angeslotener Bezeichner
Place = Plazeren
Pin = Pin
Lock Selected Objects = Sperre ausgewählte Objecten
 
Miscellaneous = Overige
Find Component = Zoek component
Component = Componenten
Footprint... = Grenfläche Bauteil...
This component is deleted! = De Componenten is bereits gewist!
Convert = Konverteren
Convert Schematic to PCB = Konvertiere Schema in PCB
The component ID will be reset according to the component prefix, this operation will clear Undo histories. Please notice: = De Componenten-ID wird entsprechend der Componenten Vorsilben zurückgesetzt, dieser Vorgang löscht den Rückgängigkeitsverlauf. Graag beachten Sie:
Please make sure the component prefixes of the schematic and PCB are corresponding = Graag stellen Sie sicher, dass die Componenten Vorsilben des Schemas en der PCB übereinstimmen
Please reset the component ID of corresponding schematic or corresponding PCB too = Graag instellen Sie auch die Componenten-ID des entsprechenden Schemas of der entsprechenden PCB zurück
Do you want to continue? = Wilt u doorgaan?
Reset Component Unique ID = Component ID aanmaken?
Component ID reset successfully! = Komopenten ID gelukt zurückgesetzen.
Convert to PCB = Converteer naar PCB
Update PCB = PCB bijwerken
Shortcut Keys Setting = Sneltoets instellen
Edit Symbol... = Schaltsymbol bewerken…
Highlight Net... = Net hervorheben…
Simulate = Simuleren
Simulation = Simulatie
Standard Mode = Standaard mode
Simulation Mode = Simulatie mode
Change to Standard Mode = Wissel in Standardmodus
Change to Simulation Mode = Wissel in Simulatiemode
Welcome to Use LCEDA = Welkom bij LCEDA
Welcome to Use EasyEDA = Welkom bij EasyEDA
Enable Education Edition Features for Free >>> = Aktiviere gratis die Lerneditionsfunktie >>>
Quick Start = Snelstart
More Help = Meer hulp
Explore = Verkennen
Message = Bericht
[start] 
Example = Voorbeeld
Forum = Forum
Tutorials = Handleiding
Videos = Videos
[/start] 
Custom Data = Aangepaste gegevens
LCEDA = LCEDA
 
Copy Result Image = Kopiere Ergebnisbild
Export Result Image = Exportiere Ergebnisbild
Simulation Result = Simulaties Ergebnis
Simulation Results... = Simulaties Ergebnisse…
Simulate this Sheet = Simuliere dit Pagina
Simulate this Project = Simuliere dit Project
Non-simulation mode, please switch to the simulation mode first and then run = Niet-Simulatiemode, graag eerst naar Simulatiemode wisselen en dan starten
Run the Document = Document ausführen
Run the Project... = Project ausführen…
Netlist for Document = Net lijst voor het Document
Netlist for Project = Net lijst voor het Project
LTspice for This Sheet... = LTspice voor dit Pagina
Spice for this Project... = Spice voor dit Project
Protel/Altium for PCB... = Protel/Altium voor PCB…
PADS for PCB... = PADS voor PCB...
FreePCB for PCB... = FreePCB voor PCB…
Eagle for PCB... = Eagle voor PCB…
Kicad for PCB... = Kicad voor PCB…
OrCAD for PCB... = OrCAD voor PCB…
BOM report... = BOM Bericht…
BOM for Document... = BOM voor het Document…
BOM for Project... = BOM voor het Project…
Pin Manager... = Pin-Beheer...
Spice Model... = Spice-Model
Layer Manager... = Lagenmanager
Net Color... = Netfarbe
Design Rule... = Entwurfsregel
Copper Area = Kupferfläche
Rebuild Selected = Auswahl opnieuw opbauen
Rebuild All = Alles opnieuw opbauen
Copper Area Manager... = Kupferflächen Beheer
Export Pick and Place File = Exportiere Auswahl en Bestand ablegen
Measure Distance = Messe Afstand
Set Canvas Origin by Mouse Location = Oberfläche anhand der MuisPositie ausrichten
Generates Pick and Place File = Erzeuge Auswahl en Bestand ablegen
Unroute All = alle Routen verwijderen
Auto Route = Automatisch Routen
Export Autorouter File(DSN) = Exportiere Autorouter Bestand (DSN)
Import Autorouter Session File(SES) = Importiere Autorouter Bestand (SES)
Autorouter File(DSN) = Autorouter Bestand (DSN)
Autorouter Session File(SES) = Autorouter Sitzungsbestand (SES)
Terminate Routing Automatically = Entferne Routing automatisch
Delete Segments = Lösche Segmente
Unroute Connections = Entferne geroute Verbindingen
Unroute Connection = Entferne geroute Verbinding
Unroute Nets = Entferne geroutete Nete
Select = Selecteren
Segments = Segmente
Connection = Verbinding
Net = Net
Apply Design Rule While Routing and Auto Placing Via = toepassen der Entwurfsregel während dem Routen en der automatischen Platzering van Durchkontaktering
 
Add SubPart = (Onder)Teil toevoegen
Annotate... = Kommenteren…
Config = Konfigureren
 
Help = Help
About = Info
Shortcut Keys = Sneltoetsen
FAQ = FAQ
Tutorials = Handleidingen
Basic Tutorials = Basis handleiding
Video Tutorials = Video handleiding
Essential Check = Grenlegender Check
Simulation Tutorials = Simulaties Anleitungen
Updated Instructions = bijgewerkte Anleitung
Open File Format = Open File Formaat
About Upgrade = Info Aktualisering
User Forum = Forum
Live Q/A = 
No live broadcast now = 
Feature Request = Gebruikerswens
Feature Requests = Gebruikerswensen
Bug Report = Bug Report
Bug Reports = Bug Reports
Tips & Skill = Tipps & Fähigkeiten
Ask for Help = Hulp vragen
Schematic Capture = Schemaauftekening
Spice Simulation = Spice-Simulatie
Non-simulation mode = Niet-Simulatiemode
PCB Layout = PCB Layout
General Discussion = Allgemeine Diskussion
More Information = Meer informatie
Privacy Policy = Datenschutzbestimmungen
#Terms of Use & Privacy Policy =
Terms of Service = Nutzungsbedingungen
Plans and Pricing = Plannen en Prijzen
Help Translate = Onderstütze bij der Infosetzung
About Us = Over ons
Contact Us = Kontaktiere Uns
Change History = Änderungshistorie
Join Us = Trete uns bei
#PCB Fabrication Capabilities =
PCB Fabrication = PCB Herstellung
Order Capabilities = Bestellfunktionen
Order Price = Bestellpreise
Order Essential Check = Wesentlicher Bestellcheck
Order FAQ = Bestell-FAQ
Order Process = Bestellprozess
Full Screen = Vollbildschirm
 
Support = Ondersteuning
[leftNavTabs] 
Support = Ondersteuning
[/leftNavTabs] 
Historical Records... = Historie Opnahme…
Extensions = Erweiterungen
Order PCB... = Bestelle PCB…
Import Changes = Importiere Wijzigingen
Press {0}F11{1} to switch to full screen. = Drücke {0}F11{1} zum Wisseln in den Vollbildschirmmodus.
Delete Selected = Lösche Ausgewähltes
Simulate... = Simuleren…
Config = Konfigureren
Terms of Service & Privacy Policy = Nutzungsbedingungen & Datenschutzbestimmungen
Help Topics = Helpthemen
3D Model(obj) = 3D-Model (obj)
3D Model(step) = 3D-Model (step)
SVG Source... = SVG bron
File Source = Bronbestand
Group These Items as a Symbol = Gruppiere dit Einzelteile als Schaltsymbol
Group These Items as a Footprint = Gruppiere dit Einzelteile als Bauteilgrenfläche
Set Canvas Origin = Tekenings-Ursprung festlegen
Document Setting = Documenteninstelling
Sheet Properties = Blatteigenschaften
Set Board Outline = Umriss PCB instellen
Teardrop... = Kegelförmige Vergrößerung
Panelize... = PCB mehrfach Maken
Check Dimension = Prüfe Abmessung
Smart Dimension = Intelligente Abmessung
Footprint Wizard = Bauteil Grenflächen Helfer
Footprint Wizard... = Bauteil Grenflächen Helfer...
Select package type = Pakettyp selecteren
Smart Dimension Properties = Intelligente Abmessungsattribuute
Global Delete = Globales Wissen
Cross Probe = Kreuzreferentie
Cross Probe and Place = Kreuzreferentie en platzeren
Paper Size = Papierformat
Register = Registreren
User Center = Gebruikers centrum
 
By Mouse Location = Naar muispositie
Set Coordinate = Zet coördinaten
By Coordinates... = naar coördinaten
By Center of Pads = Naar het midden van Pad
By Center Grid of Symbols = Naar het midden van Symbool
 
#Schematic Canvas Properties
Properties = Eigenschappen
Apply = Toepassen
Save as default = Als Vorinstelling opslaan
Canvas Properties = Tekensblatt Merkmale
Width = Breedte
Height = Hoogte
Background = Hintergren
Visible Grid = Sichtbares Gitter
Grid Visible = Gitter Sichtbar
Real-Time Track Length = Echtzeit Leiterbahn Lengte
Display Real-Time Track Length = Anzeige Echtzeit Leiterbahn Lengte
Grid Color = Gitter Kleur
Grid Size = Gitter Grootte
Grid Style = Gitter Stil
Grid.Line Width = Gitter.Lijn Dikte
Grid.Line Spacing = Gitter.Lijn Afstand
Copper to Board Outline = Kupfer naar Bordumriss
Improve Fabrication = Herstellung verbessern
Spoke Width = Speichenbreite
Stroke Color = Strichfarbe
Stroke Width = Strichdicke
Stroke Style = Strichstil
Fill Color = Füllbarbe
Selected Objects = Ausgewählte Objecten
Frame Size = Rahmengröße
Alt Snap = Alt Fangen
Snap size when pressing the Alt key = Fanggröße beim drukken der ALT Toets
Prefix Start = Vorsilben Start
 
#Text Properties
Text Properties = Texteigenschaften
Text = Text
Color = Kleur
Font Family = Lettertype
Font Size = Schriftgröße
Font Weight = Schriftstärke
Font Style = Schriftstil
Text Type = Textarten
Text Anchor = Textanker
Baseline = Basislinie
(Auto) = Automatisch
(auto) = automatisch
start = start
middle = Mitte
end = Ende
inherit = Vererben
comment = Opmerkingen
spice = Spice
normal = Normaal
italic = Cursief
Default = Standaard
Add = Toevoegen
bold = Vet
bolder = Vetter
lighter = Dunner
Failed to parse the font file: {name} = Fout bij controleren Lettertypebestand: {naam}
Please select a font file of ttf or woff format. = Kies een Lettertypebestand in het ttf of woff formaat.
Add font success: {name} = Lettertype toegevoegd: {naam}
Failed to add font: {name} = Lettertype kon niet toegevoegd worden: {naam}
Add Font = Lettertype toevoegen
Failed to parse cached font: {name} = Fout beim Prüfen der tussenopgeslagenen Lettertype: {naam}
Load cached fonts fail! = Das Laden der tussenopgeslagener Lettertypeen is mislukt!
 
#Stroke
Stroke Color = Strichfarbe
Stroke Width = Strichdicke
Stroke Style = Strichstil
Fill Color = Vulkleur
X Radius = X Straal
Y Radius = Y Straal
 
#spice
Switch mode = Modus omschakelen
The current documents will be closed, and reopen after switching mode, do you want to continue? = De huidige Documenten worden gesloten en na de mode-wissel weer geopend. Doorgaan?
PCB related documents are not allowed in emulation mode = PCB bezogene Documente sind in het Emulationsmodus niet zulässig
Please change the editor to "Simulation" mode first at the top left corner. = Graag schalten Sie den Editor eerst boven links in den Modus "Simulatie".
Please change the editor to "Standard" mode first at the top left corner. = Graag schalten Sie den Editor eerst boven links in den Modus "Standard".
Common = Gemeinsam
spice.open = spice.open
spice.close = spice.gesloten
Sources = Bronn
Instruments/Meters = Instrumente/Meter
Transistors = Transistoren
Digital Circuits = Digitale Schaltung
Operational Amplifier = Opamp
multimeter = Multimeter
multimeter Settings = Multimeter instellingen
FunctionGenerator Settings = Functiesgenerator instellingen
Voltage Source Settings = Spanningsbron instellingen
Current Source Settings = Stroombron instellingen
Powersw Settings = Netschalter instellingen
Resistor Settings = Weerstand instellingen
Capacitor Settings = Condensator instellingen
Diode Settings = Diode instellingen
voltPowersw Settings = Spanningsnetzschalter instellingen
Inductor Settings = Inductie instellingen
VCVS Settings = VCVS instellingen
CCCS Settings = CCCS instellingen
VCCS Settings = VCCS instellingen
CCVS Settings = CCVS instellingen
JFET Settings = JFET instellingen
FET Settings = FET instellingen
Transmission Line Settings = Infotragungsleitung instellingen
Oscilloscope Settings = Oscilloscoop instellingen
XFMR Settings = XFMR instellingen
LOGIC Settings = Logik instellingen
LOGICSTATE Settings = Logikstatus instellingen
DIGITALCLOCK Settings = Digitale_klok instellingen
Potentiometer Settings = Potmeter instellingen
MUTUAL_INDUCTORS Settings = Gegenseitige Inductieen instellingen
NE555 Settings = NE555 instellingen
THREE_PHASE Settings = Driefasen instellingen
Logic_Probe Settings = Logic-Probe instellingen
78XX Settings = 78XX instellingen
79XX Settings = 79XX instellingen
OPAMP5PEE Settings = OPAMP5PEE instellingen
OPAMP5PEECN Settings = OPAMP5PEECN instellingen
OPAMP3PEE Settings = OPAMP3PEE instellingen
OPAMP3PEECN Settings = OPAMP3PEECN instellingen
DELAY_FUSE Settings = Vertraging Zekering instellingen
Ratio = Ratio
K[%] = K[%]
Model = Model
States = Status
Voltage[V] = Spanning
Voltage gain[V/V] = Spanningsversterkung
Current gain[A/A] = Stroomversterkung
Transconductance[Mho] = Transconductance[Mho]
Transresistance[Ω] = Transresistance[Ω]
Voltage Source Type = Spanningsbron
Current Source Type = Stroombron
multimeter type = Multimeter Type
power type = Net Type
Voltmeter Resistance(R)(Ω) = Spanningsmeter Weerstand(R)(Ω)
Amperometer Resistance(R)(Ω) = Stroommeter Weerstand(R)(Ω)
mu.V = mu.V
mu.A = mu.A
Sine Wave = Sinusgolf
Triangular Wave = Zaagtandgolf
Rectangular Wave = Blokgolf
AC = Wisselstroom (AC)
DC = Gelijkstroom (DC)
SINE = Sinus
PULSE = Pulse
EXP = Exponentieel
SFFM = SFFM
PWL = PWL
B.spice = B.spice
DC Value[V] = DC waarde[V]
DC Value[A] = DC waarde[A]
DC offset[V] = DC offset[V]
DC offset[A] = DC offset[A]
Amplitude[V] = Amplitude[V]
Amplitude[A] = Amplitude[A]
Freq[Hz] = Freq[Hz]
Theta[1/s] = Theta[1/s]
Tdelay[s] = Tdelay[s]
Phi[deg] = Phi[deg]
Tperiod[s] = Tperiod[s]
Ton[s] = Ton[s]
Tfall[s] = Tfall[s]
Trise[s] = Trise[s]
Von[V] = Von[V]
Von[A] = Von[A]
Vinitial[V] = Vinitial[V]
Vinitial[A] = Vinitial[A]
Vpulsed[V] = Vpulsed[V]
Vpulsed[A] = Vpulsed[A]
Rise Delay[s] = Rise Delay[s]
Rise Tau[s] = Rise Tau[s]
Fall Delay[s] = Fall Delay[s]
Fall Tau[s] = Fall Tau[s]
Carrier Freq[Hz] = Carrier Freq[Hz]
Modulation Index = Modulatatie index
Signal Freq[Hz] = Signal Freq[Hz]
Time[s] = Time[s]
Value[V] = Waarde[V]
Value[A] = Waarde[A]
Waveforms = Golfvormen
Duty cycle[%] = Duty cycle[%]
Amplitude[Vp] = Amplitude[Vp]
Offset[V] = Offset[V]
Rise/Fall Time[sec] = Rise/Fall Time[sec]
Capacitance[F] = Capaciteit[F]
sComponent = sComponent
Inductance[H] = Inductie[H]
Gbw = Gbw
Slewrate = Slewrate
Avol = Avol
Rout(Ω) = Rout(Ω)
Rin(Ω) = Rin(Ω)
Ibias[A] = Ibias[A]
Inhi[V] = Inhi[V]
Inlo[V] = Inlo[V]
Isc[A] = Isc[A]
Outhi[V] = Outhi[V]
Outlo[V] = Outlo[V]
Vabsmax[V] = Vabsmax[V]
Vmin[V] = Vmin[V]
Iq[A] = Iq[A]
Cin[F] = Cin[F]
high = Hoog
low = Laag
Oscilloscope = Oscilloscoop
Logic Analyzer = Logic Analyser
Channel_A = Kanaal_A
Channel_B = Kanaal_B
Channel A = Kanaal A
Channel B = Kanaal B
Time = Tijd
Reverse = Omkeren
Simulation file exceed = Simulatiesbestand overschreden
The simulation file is too large and has been stopped for performance reasons. = Simulatiesbestand is te groot en is gestopt.
Timebase = Tijdbasis
Scale: = Schaal
X pos.(Div): = X pos.(Div):
Y pos.(Div): = Y pos.(Div):
View meter... = Meter weergeven…
The circuit has components without simulation model: = De Schaltung hat Componenten ohne Simulatiesmodell:
Your simulation interval is too short to simulate, please wait 5 seconds later and try again; if still show this message, may be you simulated over 500 times the maximum simulation times per day. = Ihr Simulatiesintervall is te kort zum Simuleren. Graag warten Sie 5 Sekenen en proberen Sie es eropnieuwt. Wenn dit Meldung immer noch angezeigt wird, haben Sie möglicherweise über het 500 fache der maximalen Simulatieszeiten per Tag simuliert.
Resistor1_US = Weerstand1_US
Resistor1_EU/IEC = Weerstand1_EU/IEC
Resistor1_3D = Weerstand1_3D
Capacitor1_US = Condensator1_US
Capacitor1_EU/IEC = Condensator1_EU/IEC
Capacitor1_3D = Condensator1_3D
Rheostat_US = Rheostaat_US
Rheostat_EU/IEC = Rheostaat_EU/IEC
Rheostat_3D = Rheostaat_3D
Capacitor_Electrolytic_US = Elco_US
Capacitor_Electrolytic_EU/IEC = Elco_EU/IEC
Capacitor_Electrolytic_3D = Elco_3D
Inductor_US = Inductie_US
Inductor_EU/IEC = Inductie_EU/IEC
Inductor_3D = Inductie_3D
Resistor2_US = Weerstand2_US
Resistor2_EU/IEC = Weerstand2_EU/IEC
Resistor2_3D = Weerstand2_3D
Multimeter = Multimeter
Multimeter_3D = Multimeter_3D
Oscilloscope = Oscilloscoop
Oscilloscope_3D = Oscilloscoop_3D
Signal_Generator = Signaal_Generator
Signal Generator_3D = Signaal_Generator_3D
Wattmeter = Vermogensmeter
Wattmeter_3D = Vermogensmeter_3D
NSSWS1080T_3D = NSSWS1080T_3D
Voltage_Source_VDC = Spanningsbron_VDC
Voltage_Source_VSin = Spanningsbron_VSin
Voltage_Source_VPULSE = Spanningsbron_VPULSE
Voltage_Source_VEXP = Spanningsbron_VEXP
Voltage_Source_VSFFM = Spanningsbron_VSFFM
Voltage_Source_VPWL = Spanningsbron_VPWL
Voltage_Source_V_Behavioral_Source = Spanningsbron_V_Variabel
Current_Source_IDC = Stroombron_IDC
Current_Source_ISin = Stroombron_ISin
Current_Source_IPULSE = Stroombron_IPULSE
Current_Source_IEXP = Stroombron_IEXP
Current_Source_ISFFM = Stroombron_ISFFM
Current_Source_IPWL = Stroombron_IPWL
Current_Source_I_Behavioral_Source = Stroombron_I_Variabel
CCCS_1 = CCCS_1
CCCS_2 = CCCS_2
CCVS_1 = CCVS_1
CCVS_2 = CCVS_2
VCCS = VCCS
VCVS = VCVS
Three_Phase_Wye_Load = Driefasen_Wye_Belasting
Three_Phase_Delta_Load = Driefasen_Delta_Belasting
78XX = 78XX
79XX = 79XX
555 = NE555
555_3D = 555_3D
Transformer_US = Transformator_US
Transformer_EU/IEC = Transformator_EU/IEC
Transformer_Center_Tapped_US = Transformator_Middentap_US
Transformer_Center_Tapped_EU/IEC = Transformator_Middentap_EU/IEC
Mutual_Inductor_US = Mutual_Inductor_US
Mutual_Inductor_EU/IEC = Mutual_Inductor_EU/IEC
Mutual_Inductor2_US = Mutual_Inductor2_US
Mutual_Inductor2_EU/IEC = Mutual_Inductor2_EU/IEC
OR2EE_US = OR2EE_US
OR3EE_US = OR3EE_US
OR4EE_US = OR4EE_US
OR2EE_CN = OR2EE_CN
OR3EE_CN = OR3EE_CN
OR4EE_CN = OR4EE_CN
NOR2EE_US = NOR2EE_US
NOR3EE_US = NOR3EE_US
NOR4EE_US = NOR4EE_US
NOR2EE_CN = NOR2EE_CN
NOR3EE_CN = NOR3EE_CN
NOR4EE_CN = NOR4EE_CN
AND2EE_US = AND2EE_US
AND3EE_US = AND3EE_US
AND4EE_US = AND4EE_US
AND2EE_CN = AND2EE_CN
AND3EE_CN = AND3EE_CN
AND4EE_CN = AND4EE_CN
NAND2EE_US = NAND2EE_US
NAND3EE_US = NAND3EE_US
NAND4EE_US = NAND4EE_US
NAND2EE_CN = NAND2EE_CN
NAND3EE_CN = NAND3EE_CN
NAND4EE_CN = NAND4EE_CN
XOR2EE_US = XOR2EE_US
XOR2EE_CN = XOR2EE_CN
XNOR2EE_US = XNOR2EE_US
XNOR2EE_CN = XNOR2EE_CN
Digital_Clock_1Hz = Digitale_klok_1Hz
Logicstate_0 = Logicstate_0
Logicstate_1 = Logicstate_1
Logic_Probe = Logic_Probe
Buffee = Buffer
INVEE_US = INVEE_US
INVEE_CN = INVEE_CN
Schmittbuffee = Schmittbuffer
LM358N_US = LM358N_US
LM358N_CN = LM358N_CN
OPAMP3PEE_US = OPAMP3PEE_US
OPAMP3PEE_CN = OPAMP3PEE_CN
OPAMP5PEE_US = OPAMP5PEE_US
OPAMP5PEE_CN = OPAMP5PEE_CN
Voltage_Controlled_Switch = Spanningsgestuurde_Schakelaar
Current_Controlled_Switch = Stroomgestuurde_Schakelaar
FUSE = Zekering
Delay_Fuse = Vertraging_Zekering
Transmission_Line = Transmissie_lijn
Crystal = Kristal
DFFEE = DFFEE
TFFEE = TFFEE
JKFFEE = JKFFEE
SRFFEE = SRFFEE
SRLATCHEE = SRLATCHEE
SRNANDFFEE = SRNANDFFEE
SRNORFFEE = SRNORFFEE
INVTSEE = INVTSEE
INVODEE = INVODEE
Cbuffer = Cbuffer
SPDT_Open = SPDT_Open
SPDT_Close = SPDT_Close
SPST_Close = SPST_Close
SPST_Open = SPST_Open
Fast_Crystal = Snelle_Kristal
Lamp = Lampeninstellingen
BCD_Segment = BCD_Segment
Seven_Segment = Zeven_Segment
Traffic_Light = Verkeerslicht
Lamp Settings = Lampeninstellingen
Power[W] = Vermogen[W]
Dropout Voltage[V] = Uitgansspanning[V]
Current[A] = Stroom[A]
Threshold[V] = Drempel[V]
Clock Rate = Klokfrekwentie
TrafficLight Settings = Verkeerslicht instellingen
BCDSegment Settings = BCDsegment instellingen
SevenSegment Settings = Zevensegment instellingen
SPDT Settings = SPDT instellingen
SPST Settings = SPST instellingen
LogicAnalyzer Settings = Logiganalyser instellingen
Fuse Settings = Zekering instellingen
Wattmeter Settings = Vermogensmeter instellingen
open = open
close = gesloten
Common Anode = Common Anode
Common Cathode = Common Cathode
AC Amplitude = Wisselstroom [AC] Amplitude
AC Phase = Wisselstroom [AC] Fase
There are some parts haven't spice model, please use "EElib" and "Spice Symbol" at "Libraries" of "Simulation" mode, or you can assign the spice model for them: = Es gibt einige Teile, die geen Spice Model haben, verwenden Sie graag "EElib" en "Spice Schaltsymbol" unter "Bibliotheken" des "Simulaties" Modus, of weisen Sie ihnen het Spice Model zu:
 
#Pin
Pin Properties = Pin Eigenschappen
Orientation = Richting
Line 45° = Lijn 45°
Line 90° = Lijn 90°
Arc 45° = Boog 45°
Arc 90° = Boog 90°
Free Angle = Vrije hoek
Start X = Start (X)
Start Y = Start (Y)
Length = Lengte
Name = Naam
name = naam
Number = Nummer
Spice Pin Order = Spice Pin Rijnfolge
Display Number = Nummer weergeven
Clock = Klok
Show = Weergeven
Electric = Elektrisch
 
#Junction
Junction Properties = Verbindingspunt Eigenschappen
X Location = X-Standort
Y Location = Y-Standort
Size = Grootte
Color = Kleur
 
#Net Label
Net Label = Net label
 
#Part
Prefix = Prefix
 
#Image Properties and Dialog
Add Image = Afbeelding toevoegen
Image Properties = Afbeeldingeigenschaften
Image URL = Afbeelding-URL
Input an image URL = Afbeelding-URL invoeren
Invalid image URL = Ongeldige Afbeelding-URL
Invalid Prefix = Ongeldig Prefix
Failed to load the image = Kon Afbeelding niet laden
Image URL contains special characters = Afbeelding-URL beinhaltet Sonderzeichen
From Web URL = Von Web (URL)
From Local Computer = Von lokalem Computer
Please select a png/gif/jpg file. = Graag Afbeeldingbestand selecteren (PNG/GIF/JPG)
Please select an image file. = Graag Afbeeldingbestand selecteren.
Select an image file = Afbeeldingbestand selecteren
Insert Image to PCB = Afbeelding in PCB einfügen
Tolerance = Tolerantie
tolerance = tolerantie
capacitance = capaciteit
frequency = frequentie
Rated Voltage = Spanning[V]
Rated Current = Stroom[A]
resistance = weerstand
Resistance = Weerstand
Resistance[Ω] = Weerstand[Ω]
inductance = Inductie
Operating Temperature = Bedrijfstemperatuur
Shape Invert = Vorm omkeren
Image Size = Afbeelding grootte
Color Tolerance = Kleur tolerantie
Simplify Level = Vlak vereenvoudingen
Corner Threshold = Eck-Schwell waarde
 
#PCB Canvas Properties
Units = Eenheden
Snap Size = Rastergrootte
Other = Andere
Routing Width = Routing-Breedte
[router] 
Routing Width = Routing-Breedte
[/router] 
Please using hotkey {0}{key1}{1} or {2}{key2}{3} to change track width while on routing. = Graag Hotkeys {0}{key1}{1} of {2}{key2}{3} betätigen, um die spoor breedte während dem Routing naar modifizeren.
Routing Angle = Verlegewinkel
Routing Conflict = Routing-Konflikt
Remove Loop = Lus verwijderen
Cut SilkScreen = Siebdruck schneiden
Grid = Raster
Grid 90 = Raster 90
Grid 45 = Raster 45
Copper Zone = Koper gebied
Visible = Zichtbaar
Invisible = Onzichtbaar
Ignore = Negeren
Block = Blokkeren
RoundTrack = Rond spoor
 
#Track
Track Properties = Spoor eigenschappen
Layer = Laag
Net = Net
Start X = Start X
Start Y = Start Y
End X = Eind X
End Y = Eind Y
ID = ID
 
#Pad Properties
Pad Properties = Pad Eigenschappen
Shape = Form
Hole(D) = Lochdurchmeter
Center X = Mitte X
Center Y = Mitte Y
Round = Rond
Oval = 
Hole Shape = Lochform
Slot = 
Hole(Length) = Lochlänge
Plated = Infozogen
None = Geen
Paste Mask Expansion = Maskenerweiterung einfügen
Solder Mask Expansion = Lötmaskenerweiterung
 
#Via Properties
Via Properties = Durchkontaktering Eigenschappen
Diameter = Diameter
Drill Diameter = Boor diameter
 
#Hole Properties
Hole Properties = Gat eigenschappen
 
 
#TEXT
Text Properties = Tekst eigenschappen
Line Width = Lijn dikte
Rotation = Rotatie
Fonts Management = Lettertype beheren
 
#Dimension Properties
Dimension Properties = Afmeting Eigenschappen
 
#Footprint Properties
Component Properties = Componenten eigenschappen
Display Prefix = Prefix weergeven
Pin Name = Pin Naam
Pin Number = Pin Nummer
Spice Pin Number = Spice Pin Nummer
Graphics = Grafiek
Pattern = Patroon
 
Pin: = Pin:
Netflag: = Net vlag:
Netlabel: = Net label:
NetPort: = Net Port:
Voltage Probe: = Spanning meter:
Pin: = Pin:
Hidden Pin: = Verborgen Pin:
Unknown: = Onbekend:
#Arc Properties
Arc Properties = Boog Eigenschappen
Start Angle = Begin hoek
End Angle = Eind hoek
Rotation Direction = Draairichting
 
#Rect Properties
Rect Properties = Rechthoek eigenschappen
Round radius = Afronding straal
 
#Circle Properties
Circle Properties = Cirkel eigenschappen
Radius = Straal
 
#CopperArea Properties
CopperArea Properties = Kopergebied Eigenschappen
Clearance = Tussenruimte
Pad Connection = Pad Verbindingen
Direct = Direct
Spoke = Speichenförmig
Keep Island = Einzelne Bereiche
Fill Style = Füllstil
CopperArea conflict: copper area outlines in same layer with different net names must not overlap = Kopergebieds Konflikt: Kupfer Konturen in der gleichen Lage met unterschiedlichen Netnaamn mogen niet überlappen.
Copper area rebuild complete! You can set "Copper Zone" as "Visible" at the right-hand property panel after single click the empty area. = Wiederaufbau des Kopergebieds abgesloten! Sie kunnen "Kupferzone" in het rechten Eigenschaftsfenster als "sichtbar" einstellen, naardem Sie den leeren Bereich einmal angeklickt haben.
Please create board outline first. = Graag aanmaken Sie eerst den Platinen Umriss.
Board outlines are not closed. = Platinenumriss is niet gesloten.
Rebuild CopperArea = Kopergebied opnieuw opbauen
Edit Points = Punkte bewerken
Direct = Direct
Spoke = Speichenförmig
No Solid = Niet Vollflächig
Board Cutout = Platinenausschnitt
Solid = Vollflächig
[copperArea] 
None = Geen
[/copperArea] 
 
#Custom Properties
Custom Properties = Aangepaste eigenschappen
Fixed Properties = Vaste Eigenschappen
Add new parameter = Nieuwe Parameter toevoegen
Add New Parameter = Nieuwe Parameter toevoegen
Add New Supplier = Nieuwe Leverancier toevoegen
Mounted = Gemonteerd
Unknown = Onbekend
 
Custom = Aangepast
Scan the QR code below and open it on the mobile side = Scannen Sie den onderstehenden QR-Code en openen Sie ihn op der mobilen Pagina
How to create a single layer PCB = So aanmaken Sie eine einlagige PCB
Currently doesn't support layout single layer directly, please refer at: = Onderstützt derzeit het Layout einer einzelnen Ebene niet direkt, graag beachten Sie:
 
#Dialog Register
Create an account = Account maken
Username = Gebruikersnaam
Password = Wachtwoord
Confirm Password = Wachtwoord bevestigen
Email = email
Please read this before you register = Graag lezen, voordat u zicht aanmeldt
Hi {username} = Hallo {usernaam}
 
#Dialog lostPassword
Lost Password... = Wachtwoord vergeten
Find the password using your email = Wachtwoord per email aanmaken
 
 
 
#Dialog Login
Login = Inloggen
Username or Email = Gebruikersnaam of email
Remember Me = Aanmelding bewaren
Third party = Derde partij
Login and Register = Aanmelden en registreren
Your login information seems expired, please login again. Don't need to close the opening files, you can continue to save them after login. = Uw huidige sessie is afgelopen, graag opnieuw aanmelden. Geopende bestanden blijven bestaan en kunnen bij de volgende Login opgeslagen worden.
 
#Dialog Reset Password
Reset a password using your email = Wachtwoord per email aanmaken
Your registered email = Uw email adres
 
#Dialog Reaction
Re-send an activation code to your email = Aktiveringscode opnieuw naar uw email adres gestuurd
 
#Dialog Invite
Invite friends to register = Vrienden uitnodigen
Your friend's email = Email adres van uw vriend
 
#Dialog Add A New Parameter
Add a new parameter = Nieuwe parameter toevoegen
Key = Sleutel
Value.new_para = Waarde.nieuwe_para
In BOM = In BOM
Add into BOM = Toevoegen aan BOM
Invalid key = Ongeldige sleutel
This field is required. = Dit veld is verplicht
 
#Dialog Change Your Password
Change your password = Wachtwoord wijzigen
Old password = Oude wachtwoord
New Password = Nieuwe wachtwoord
Confirm Password = Wachtwoord bevestigen
 
#Dialog Create New Design
Save as a New Project = Opslaan als nieuw Project
Save as a schematic = Opslaan als Schema
Save as Symbol = Opslaan als Symbool
Save as a spice Symbol = Opslaan als spice Symbool
Save as a spice subckt = Opslaan als spice subckt
YOU MUST CREATE A SPICE SYMBOL WITH EXACTLY THE SAME NAME AS THIS SUBCKT = Sie müssen een Spice Schaltsymbol met exakt dem gleichen Naam erzeugen wie het (Onder)Schaltsymbol.
Save as a PCB file = Opslaan als PCB Module
Save as Footprint = Opslaan als Footprint
Save as a Schematic Module = Opslaan als Schema Module
Save as a PCB Module = Opslaan als PCB Module
Save as 3D Model = Opslaan als 3D Model
Save as a WaveForm = Opslaan als Golfvorm
Title = Titel
Share = Delen
Add file = Bestand toevoegen
Visibility = Zichtbaarheid
Allow Comments = Opmerkingen toestaan
Public (Anyone can see this project but only you can modify it.) = Öffentlich (Nur Sie kunnen het Project wijzigen. Jeder kan es sehen.)
Private (Only you can see and modify this project) = Privat (Nur Sie kunnen het Project wijzigen en sehen.)
Create new project success! = Nieuw Project gelukt erstellt!
You can now create files under this project = Onder diesem Project kunnen nun Bestanden erstellt worden.
This file must be saved under a project, choose other project or create a new project = Diese Bestand muss unter einem Project opgeslagen worden. Graag in existerendes selecteren of een Nieuw aanmaken.
Please login to save this kind of document = Graag aanmelden um dit Document naar opslaan
Duplicated project title = Dubbele project titel
#Duplicated document title =
Project does not exist = Project bestaat niet
Document does not exist = Document bestaat niet
document not exists = dokument bestaat niet
 
Categories = Categorieën
Project = Project
Short description = Korte beschrijving
Content = Inhoud
Modify this project info. = Projectinfo wijzigen.
Modify this file info. = Bestandinfo wijzigen.
Notice = Opmerking
Search for it before creating a new one. = Zoek er naar, voordat u een nieuwe maakt.
Manufacturer Part Number = Fabrikant Onderdeelnummer
Supplier = Leverancier
Or = Of
Supplier Part = Onderdeel van leverancier
Supplier Part Number = Leverancier Onderdeelnummer
Link = Link
link = link
The professional function please refer at: = De professionele functie vindt u onder:
 
#Dialog Clone My Part
#Clone it to a project =
#Clone it, then edit it =
Clone your file = Kloon uw bestand
 
#Dialog Subckt
Attach a Subckt to this spice symbol = (Onder)Schaltsymbol naar diesem Spice Schaltsymbol einarbeiten.
Subckt string = Onderserie
Spice symbol title just allow [0-9][a-z][A-Z] and _ = Spice Schaltsymbole Titel erlauben nur [0-9][a-z][A-Z] en _ als Tekens
 
#Design Manager
Design Manager = Ontwerp Beheer
Nets = Netten
DRC Errors = Ontwerpregel fouten
Are you sure you want to unroute this net? = Dit Net echt unrouten?
Unroute = Unrouten
Track Length = Spoor lengte
Via/Hole Outer Size = Äussere Omvang Via/Loch
Filter nets = Nach Nete filtern
Design Rule Checking = Designregelprüfung
Board Outline = Platinenumriss
Plane Zone = Zone Ebene
[drcRule] 
Width = Breedte
DRC Width = DRC-Breedte
Length = Lengte
DRC Length = DRC-Lengte
Drill Diameter = Boor diameter
DRC Drill Diameter = DRC-Boor diameter
Diameter = Diameter
DRC Diameter = DRC-Diameter
Object = Object
DRC Clearance = DRC-Afstand
[/drcRule] 
#It will take a while to unroute this net, do you want to continue? =
More than one netlabel is found in wire, please checked whether this is correct, if you design it on purpose, please ignore this warning. = Es is meer dan een Netnaam in een draad gevonden, graag controleren of dit juist is. Als dit met opzet zo ontworpen is, kunt u deze waarschuwing negeren.
Incomplete net, a complete net should contain two or more pins, if you design it on purpose, please ignore this warning. = Onvolledig Net, een volledig Net moet twee of meer Pins bevatten. Als dit met opzet zo ontworpen is, kunt u deze waarschuwing negeren.
This netlabel is not connected with any pin. = Deze Netnaam is met geen Pin verbonden.
Incomplete connection, please check. = Onvolledige verbinding, graag controleren.
The clearance between two objects is less than the Design Rule Checking (DRC) clearance which has different nets. = Afstand tussen twee Objecten is kleiner dan de in de Design Rules (DRC) opgegeven minimum afstand tussen twee verschillende netten.
The diameter is less than Design Rule Checking (DRC) diameter = Diameter is kleiner dan de in de Design Rules (DRC) opgegeven minimum Diameter.
The drill diameter is less than Design Rule Checking (DRC) drill diameter = Boor diameter is kleiner dan de in de Design Rules (DRC) opgegeven minimum Boor diameter.
The track length is longer than Design Rule Checking (DRC) track length = De spoor lengte is langer dan die in de Design Rules (DRC) opgegeven maximum spoor lengte.
The track width is less than Design Rule Checking (DRC) track width = De spoor breedte is kleiner dan die in de Design Rules (DRC) opgegeven minimum spoor breedte
 
#Dialog Simulation
Show your simulation report = Schema Simulatiesrapport weergeven
Download netlist = Net lijst downloaden
Run = Starten
Components = Componenten
 
#Dialog Import
Import file from your computer = Bestand van de Computer importeren
Maximum file size: 30 MB = Maximale Bestand omvang: 30MB
Maximum file size: 100 MB = Maximale Bestand omvang: 100MB
Chose file = Kies een bestand
File Operation = Bestand bewerking
Import File = Bestand importeren
Extract Libs = Bibliotheken uitpakken
No Libs! = Geen Bibliotheken
Import File and Extract Libs = Bestand importeren en Bibliotheken exporteren
File type = Soort bestand
The file size is too large. = Bestand omvang is te groot.
Please selected the file type. = Kies bestandsoort
No component was found! = Geen Componenten gevonden!
Import successfully = Import gelukt
Import failed = Import mislukt
Click OK to continue with the import = "OK" betätigen um met Importvorgang fortzufahren
Select None = Niets selecteren
 
#Dialog Modify Symbol Information
Modify symbol information = Schaltsymbol informatie wijzigen
Spice Prefix = Spice-Prefix
Hide Pin = PIN verbergen
Pin Manager = Pin Beheer
When a power pin is hidden, it will be marked as netlabel, you don't need to wire it. If you use it as simulation, please show it or create a GND/VCC Net for it. = Wenn een Net Pin ausgeblendet ist, wird er als Netnaam gekennzeichnet, Sie müssen ihn niet verdrahten. Wenn Sie es als Simulatie verwenden, weergeven Sie es graag of aanmaken Sie een GND/VCC-Net davoor.
Assign = Toewijzen
Supplier.bom = Leverancier.bom
LCSC.bom = LCSC.bom
Price = Prijs
Quantity.bom = Hoeveelheid.bom
Package.bom = Paket.bom
Components.bom = Componenten.bom
Manufacturer Part.bom = Fabrikant onderdeel.bom
Manufacturer.bom = Fabrikant.bom
 
One-click Purchasing at LCSC = Een-klik aankoop bij LCSC
Order Parts = Teile bestellen/Voorraadstand controleren
Export BOM = BOM exporteren
Upload to LCSC ERP = 
No components, upload failed! = Geen Componenten, upload mislukt!
Upload to LCSC ERP failed, please try again later. = Upload naar LCSC ERP mislukt, probeer het later opnieuw.
Current BOM upload to Chip Manager of LCSC successfully, click "OK" button to access Chip Manager. = 
Upload to LCSC ERP failed, found some components miss some properties value, please check property "Footprint, Manufacturer Part" value if exist. = Upload naar LCSC ERP mislukt, bij sommige componenten missen de waarden bij eigenschappen, controleer de "Footprint, Manufacturer Part" waarde.
 
Export PCB BOM = BOM der PCB exporteren
Export Schematic BOM = BOM des Schemas exporteren
ID.bom = ID.bom
Name.bom = Naam.bom
[bom] 
Name = Naam
LCSC Assembly = LCSC Assemblage
Value = Waarde
ID = ID
Supplier = Leverancier
LCSC = LCSC
Price = Prijs
Quantity = Hoeveelheid
Package = Gehäuse
Components = Componenten
Manufacturer = Fabrikant
[/bom] 
Manufacturer Part = Fabrikantnummer
 
#Dialog Run
Run your simulation = Start de simulatie
Transient = Eenmalig
Maximum Timestep = Maximale tijdsduur
Stop Time = Stop tijd
Start Time = Start tijd
 
AC Analysis = Wisselstroom Analyse
Type of Sweep = Type signaalverloop
Number of points = Aantal punten
Start Frequency = Startfrequentie
Stop Frequency = Stopfrequentie
 
DC sweep = Gelijkstroom Signaalverlauf
Source to Sweep = Bron des Signaalverlaufs
Start Value = Start waarde
Stop Value = Stop waarde
Increment = Toename
DC Transfer = Gelijkstroomübertragung
Output = Uitgang
Source = Bron
 
DC op pnt = Gelijkstroomanalyse met Bronn waardeen durchführen
Compute the DC operating point treating capacitances as opens and inductances as shorts = Berechne den Gelijkstroom Betriebspunkt wie met openen Condensatoren en met kurzgeslotenen Inductieen.
 
#Dialog Share Info
Active File = Aktive Bestand
Active Project = Aktive Project
Readonly = Alleen lezen
Editable = Wijzigbaar
Active file's owner project page = Projectseite des huidigen ProjectEigenaars
Active project editor page = Pagina des huidigen Projectbearbeiters
 
#Dialog Document Recovery
All Projects = Alle projecten
Document Recovery = Documenten aanmaken
Unsaved files = Niet opgeslagen bestanden
Please select a file! = Kies een bestand!
Please expand the folder first, then select a document to recover. = Map eerst uitpakken, dan een bestand kiezen om te aanmaken.
Are you sure you want to remove this backup? = Deze Backup echt verwijderen?
 
#Dialog Find Libs
Search = Zoekn
Search Results = Zoekresultaten
Search and press Enter = Zoekn en Enter drukken
Keywords at least 3 characters = Zoekfilter (minstens 3 tekens)
Assembled = Gemonteerd
Verified = Geverifieerd
In stock = Op voorraad
{page} of {pagecount} pages = Pagina {page} van {pagecount}
Common Modules = Algemene modules
User Contributions = Bijdragen van gebruikers
More = Meer
Modify Model... = 
Add Favorite = Aan Favorieten toevoegen
Remove Favorite = Uit Favorieten verwijderen
Add Sub Part = Onderdeel toevoegen
Untagged = Niet getagged
Package = Behuizing
package = behuizing
Title(PartNO) = Titel (Onderdeelnummer)
No Data! = Geen gegevens!
Quantity = Hoeveelheid
Manufacturer Part = Fabrikantnummer
manufacturer Part = fabrikantnummer
Manufacturer = Fabrikant
manufacturer = fabrikant
voltage = spanning
Library = Bibliotheek
LCSC Assembled = Durch LCSC montiert
JLCPCB Assembled = Durch JLCPCB montiert
User Contributed = Von Benutzer angefertigt
Symbol = Symbool
Follow = Volgen
Types = Typen
Classes = Klassen
power = vermogen
Power = Vermogen
LCSC Part# = LCSC Onderdeel#
Stock = Voorraad
Report Error... = Fout melden...
Report Error = Fout melden
Thanks for your feedback! = Dank voor uw feedback!
Report error success, thanks for your report! = Fout met succes gemeld. Dank voor uw feedback!
The content must be at least 2 characters! = De inhoud moet tenminste 2 tekens zijn!
This library is user contributed, please check before using. = Let op: Bibliotheek door Derden gemaakt. Wij zijn niet verantwoordelijk voor de juistheid.
[lib] 
All = Alle
System = Systeem
Personal = Persoonlijk
Created = Gemaakt
Favorite = Favoriet
No Team found. Please join or create a team first. = Geen Team gevonden, graag eerst eines aanmaken.
Create a team = Team aanmaken
No follow user found. Please follow your friend first. = U volgt nog geen andere gebruikers.
[/lib] 
 
 
BUY = KOPEN
In Stock = Op voorraad
Out of Stock = Niet op voorraad
Minimum = Minimum
Distributor = Leverancier
 
Capacitance = Capaciteit
Frequency Tolerance = Frequentietolerantie
Power (Watts) = Vermogen (Watt)
Power - Max = Vermogen - Max
Frequency = Frequentie
Voltage Rating(Vdc,Vac) = Nennspanning (Vdc, Vac)
Voltage = Spanning
Current Rating = Nennstroom
Rated current = Nennstroom
Resistance (Ohms) = Weerstand (Ohm)
Resistance(Ohms) = Weerstand (Ohm)
Inductance = Inductie
FET Type = FET-Typ
Current Rating(Max) = Nennstroom (Max)
Impedance @ Frequency = Impedantie bij Frequentie
Voltage - Input (Max) = Ingangspanning (Max)
Voltage - Input (Min) = Ingangspanning (Min)
Voltage - Supply = Betriebsspanning
Voltage - Max = Spanning - Max
Current - Output = Uitgangstroom
 
#Dialog Export Your Works
Export your works = Exporteren Sie Uw Arbeit
Export to = Exporteren naar
Zoom = Zoom
Image Type = Afbeeldingtyp
Qualify = Qualifizeren
0 means real size = 0 betekent original Grootte
Merged layer = Vereinigte Lagen
Separated layer = Getrennte Lagen
Paged layer = Ausgelagerte Lage
Layer = Lage
Export = Export
Mirror = Spiegel
TopLayer = Bovenste laag
BottomLayer = Onderste laag
TopSilkLayer = Bovenste opschrift laag
Protractor Properties = Hoekmeter Eigenschappen
BottomSilkLayer = Onderste opschrift laag
 
BoardOutLine = Platinenumriss
TopAssembly = Obere Montage Lage
BottomAssembly = Ondere Montage Lage
Mechanical = Mechanisch
DocumentLayer = Documenten Lage
Inner{number} = Innere {number}
Substrate{number} = 
Color = Kleur
Full Color = Vollfarbe
Canvas Setting = Tekeningsinstellingen
Full Graphics = Vollgrafiek
Assembly Drawings = Montagetekening
Object Outlines = Object Außenlinien
Invalid file format = Falsches Bestandformat
Failed to export file = Bestandexport mislukt
Download now = Jetz downloaden
Wire Width = Drahtdicke
Sheet = Pagina
Merged sheet = Zusammengefügte Pagina
Separated sheet = Getrennte Pagina
Engine = 
Exporting PDF = PDF exporteren
Export 3D Model = 3D Model exporteren
[exportDocument] 
Size = Grootte
[/exportDocument] 
 
#Dialog Import Changes
Confirm Importing changes information = Importierte Wijzigingen Bestätigen
You can't undo this operation, Please run a Design Rule Checking (DRC) after this operation. = Aktie kan niet rückgängig gemacht worden. Graag Designregelprüfung (DRC) naar dieser Operatie durchführen.
Apply Changes = Wijzigingen toepassen
This is a simple Design Rule Checking (DRC). = Dies is een simple Designregelprüfung (DRC).
It just can help you to find the obvious errors = Hiermet kunnen opensichtliche Fout während des Entwurfs gevonden worden.
There are some unfinished nets, do you want to check the nets first? = Enkele Nete sind niet ganz gesloten, dit eerst controleren?
Yes, Check Nets = Ja, übeprüfen
No, Keep Going = Nee, weitefahren
 
#Dialog Layer Manager
Configured = Konfigureren
Layer Name = Lagen Naam
TopPasterLayer = Obere SMD-Bereich Lage
BottomPasterLayer = Ondere SMD-Bereich Lage
TopSolderLayer = Obere Löt Lage
BottomSolderLayer = Ondere Löt Lage
TopPasteMaskLayer = Obere SMD-Bereich Maskerings Lage
BottomPasteMaskLayer = Ondere SMD-Bereich Maskerings Lage
TopSolderMaskLayer = Obere Lötmaskerings Lage
BottomSolderMaskLayer = Ondere Lötmaskerings Lage
ComponentShapeLayer = Componenten Form Lage
LeadShapeLayer = Lötform Lage
ComponentMarkingLayer = Componenten Makerings Lage
Ratlines = Leiterbahnen(Unverlegt)
Ratlines Color = Leiterbahnen Kleur(Unverlegt)
Manage Colors = Verwalte Kleurn
BoardOutline = Platinenumriss
Multi-Layer = Meerfachlagen
Hole = Bohrung
DRCError = DRCFout
Setting = Instelling
Drawing area = Tekensbereich
Export area = Exportbereich
Transparency(%) = Transparez(%)
Copper Layer = Kuppfer Lage
Signal = 
Plane = Ebene
Non-Signal = Niet-Signaal
Other = Andere
Please delete all the objects of the layers first! The layers are: = Graag wissen Sie eerst alle Objecten der Lagen! De Lagen sind:
You are converting Signal Layer to Plane Layer, There're some non-track objects remain on following layers. Please delete the objects manually on the canvas. = Sie konverteren die Signaal Lage in eine Flächen Lage. Es verblijven einige Niet Leiterbahn Objecten op den folgenden Lagen. Graag wissen Sie die Objecten manuell op der Tekensfläche.
Please delete all the objects of this layer first! = Graag wissen Sie eerst alle Objecten dieser Lage!
 
#Dialog Fabrication Output
Create Files = Erzeuge Bestanden
Check your {0}Gerber files{1} carefully before sending them to the factory = Infoprüfen Sie Uw {0}Gerber Bestanden{1} sorgfältig, bevor Sie sie an het Werk senden
Download free Gerber Viewer (gerbv) = Laden Sie den freien Gerber Viewer (gerbv) herunter
Before generating the Gerber files = Vor dem Genereren der Gerber Bestanden
Please check the packages size and orientation carefully. = Graag controleren Sie die Grootte en Ausrichtung der Pakete sorgfältig.
Please check for Design Rule Checking (DRC) errors in the Design Manager. = Graag prüfen Sie in het Design Beheer op Fout bij de Design Rules (DRC).
Please rebuild the copper area after modifying tracks and packages. = Graag bauen Sie den Kopergebied opnieuw op, naardem Sie Leiterbahnen en Pakete geändert haben.
After generating the Gerber file, please use the {0}Gerber Viewer{1} to check whether it conforms to the design requirements. = Verwenden Sie naar dem Genereren der Gerber-Bestand den {0}Gerber Viewer{1}, um naar controleren, ob sie den Designanforderungen entspricht.
Order PCB/SMT = Bestelle PCB/SMT bij JLCPCB
Found the complicated polygon that object cannot be generated at Gerber, please remove or replace = Kompliziertes PolygonObject gevonden, het bij Gerber niet generiert worden kann, graag verwijderen of vervangen
ID: {id}, Object: {object}, Location: {location} = 
 
#Dialog DRC
Item = Artikel
Value = Waarde
value = waarde
Unit = Einheit
Track Width = spoor breedte
Track to Track = Leiterbahn naar Leiterbahn
Track to Pad = Leiterbahn naar Pad
Pad to Pad = Pad naar Pad
Via to Via = Durchkontaktering naar Durchkontaktering
Via Hole Size = Durchgangbohrungs Grootte
Realtime DRC = Echtzeit Designregelprüfung (DRC)
{0} is too small! = {0} is naar klein!
Invalid DRC Rule = Unültige Designregelprüfung(DRC) Regel
Rule = Regel
Via Diameter = Durchkontaktering Diameter
Via Drill Diameter = Durchkontaktering Boor diameter
Net List = Net lijst
Rule = Regel
Set Rule = Regel instellen
Check Object to Copper Area = Object naar Kopergebied controleren
Show DRC Boundary while Routing = DRC-Grens während Routing weergeven
Check Object to Board Outline = Object naar Platinenumriss controleren
Rule name already exists! = Regelnaam bestaat al!
You should not delete default rule! = Standardregel moet niet gewist worden!
Rule list contains invalid rule setting! = Regelliste beinhaltet ungeldige Konfigurationen!
Duplicate rule name exists! = Duplikat van Regelnaamn bestaat bereits!
via diameter is smaller than via drill diameter! = Durchkontaktering Diameter is kleiner dan der Lochdurchmeter!
Currently rule name is not allowed to contain magical characters like . and $ = Regelnaamn mogen Sonderzeichen wie . en $ niet beinhalten.
[drcRule] 
All = Alle
[/drcRule] 
 
#Dialog Update PCB 
Update PCB(Synchronizing PCB from schematics) = PCB bijwerken (PCB aus Schaltplänen synchroniseren)
 
 
#Dialog Hotkey
Change Canvas Unit = Canvas eenheid wijzigen
Copy Selected Object(s) by Reference Point = Gewählte Objecten bij Referentiepunkt koperen
Fullscreen = Vollbildschirm
Undo the Previous Draw = Vorige Tekening Rückgänig machen
Set Canvas Origin by Coordinate = Tekeningsursprung bij Coördinate instellen
Switch to the Next Signal Layer = Zur nächste Signaallage wisselen
Switch to the Previous Signal Layer = Zur vorherige Signaallage wisselen
Switch object to top layer or bottom layer = Object tussen oberen of unteren Lage wisselen
Cycle Forward to the Next Open Tabbed Document = Zum nächsten geöffnet Document in het Tab wisselen
Cycle Backward to the Previous Open Tabbed Document = Zum vorherigen geöffnet Document in het Tab wisselen
Switch to the Previous Layer(on the Numeric Keypad) = Zur vorherigen Lage wisselen (Numerisches Keypad)
Switch to the Next Layer(on the Numeric Keypad) = Zur nächsten Lage wisselen (Numerisches Keypad)
Toggle Layers Which is Not Active = Niet aktive Lage umschalten
Hotkey Setting = Sneltoetsen Instelling
Document Type = Documenten soort
Shortcut = Snelkoppeling
Function = Functie
ALL = Alle
SCH = SCH
Rotate Selected Objects = Geselecteerde Objecten roteren
Scroll or Move Selected Left = Selektie naar links schuiven
Scroll or Move Selected Right = Selektie naar rechts schuiven
Scroll or Move Selected Up = Selektie naar boven schuiven
Scroll or Move Selected Down = Selektie naar beneden schuiven
Set canvas origin to the center grid of graphics in symbol; Set canvas origin to the center of pads in footprint. = Stellen Sie den Tekeningsursprung op het mittlere Gitter der Grafieken in het Schaltsymbol ein; Legen Sie den Tekeningsursprung op die Mitte der Pads in der Bauteilgrenfläche fest.
Cross Document Paste = Documentenübergreifend einfügen
Explore & Find Components = Componenten erkenen en suchen
Select All = Alles Selecteren
Cancel Current Drawing = Huidige Tekening Annuleren
Save = Opslaan
Drag Tool = Nehme Werkzeug
Draw Wire = Teken Leitung
Draw Bus = Teken Databus
Bus Entry = Databus Einspeisung
Junction = Verbindingsstelle
Net Flag GND = Net aanduiding GND
Net Flag = Net aanduiding
Draw Polyline = Teken Polyline
Draw Polygon = Teken Meerhoek
Draw Bezier = Teken Bezierkurve
Draw Arc = Teken Boog
Draw Rect = Teken Rechthoek
Draw Ellipse = Teken Ellipse
Freehand Draw = Freihandtekening
Freedraw = Freihand
Draw Text = Teken Text
Edit Selected Symbol = Editiere Ausgewähltes Schaltsymbol
Draw Track = Teken Leitung
Draw Circle = Teken Kreis
Cycle Select Object at Current Location = Am huidigen Standort ausgewähltes Object durchwisselen
Draw Dimension = Teken Afmeting
Draw Connect = Teken Verbinding
Draw CopperArea = Teken Kopergebied
Change to TopLayer;<br/>Change Selected Component's Layer to TopLayer; = Zur obersten Lage wisselen;<br/>Ausgewählte Componentenlage zur obersten Lage wijzigen;
Change to BottomLayer;<br/>Change Selected Component's Layer to BottomLayer; = Zur untersten Lage wisselen;<br/>Ausgewählte Componentenlage zur untersten Lage wijzigen;
Change to Inner1 = Wissel naar Inner1
Change to Inner2 = Wissel naar Inner2
Change to Inner3 = Wissel naar Inner3
Change to Inner4 = Wissel naar Inner4
Highlight Net = Net hervorheben
Highlight Network = 
Unhighlight Network = 
Place Pad = Platziere Pad
Place Via = Platziere Durchkontaktering
Measure = Meten
Change Routing Angle = Verlegewinkel wijzigen
Change Routing Conflict = Verlegekonflikt wijzigen
Decrease Routing Width = Verlegedicke verkleinern
Increase Routing Width = Verlegedicke vergrößern
Decrease Snap Size = Vergrößere Fanggröße
Increase Snap Size = Verkleinere Fanggröße
Change Copper Zone Visible or Invisible = Kupferzone sichtbar of unsichtbar wijzigen
Rebuild All Copper Area = Kopergebieden opnieuw opbauen
Toggle PCB Net Display = Nettoanzeige PCB umschalten
Show Property Dialog When Placing Object;<br/>Show Location Setting Dialog When Pasting Object(s) = Attributdialog beim Platzeren van Objecten weergeven;<br/>Dialogfeld Standortinstelling beim Einfügen van Objecten weergeven
Show Property Dialog When Placing Object;<br/>Show Absolute Offset Dialog When Selecting Object(s);<br/>Show Location Setting Dialog When Pasting Object(s) = Attributdialog beim Platzeren van Objecten weergeven;<br/>Absoluter Versatzdialog beim Selecteren van Object(en) weergeven;<br/>Positiesinstellingsdialog beim Einfügen van Objecten weergeven
Show Relative Offset Dialog When Selecting Object(s) = Dialogfeld "Relativen Versatz weergeven" bij der Auswahl van Objecten
Open the FAQ Page = Openen Sie die FAQ-Pagina
Move Object(s) by Reference Point = Object(e) naar Referentiepunkt verschieben
Choose Favorite Track Width While Routing = Selecteern Sie die bevorzugte spoor breedte beim Routing
Copy Selected Object(s) and Paste Repeatedly = Ausgewählte(s) Object(e) koperen en wiederholt einfügen
 
#My Projects Tree Menu
New Project = Nieuw Project
New Schematic = Nieuw Schema
New PCB = Nieuwe PCB
New Spice Subckt = Nieuw Spice (Onder)Schaltsymbol
Modify = Wijzigen
Delete = Wissen
Add sub part = Zum (Onder)Teil toevoegen
Clone = Klonen
Version History = Versie historie
Refresh List = Lijst opnieuw laden
Create New Project = Nieuw Project aanmaken
Delete = Wissen
Attachment = Bijlage
Archive = Archief
Transfer = Transfer
Manage Project = Project beheren
 
#Dialog Verify Package
Footprints Verification = Bauteilgrenflächen Infoprüfung
 
#Dialog Edit Polygon Pad points
Edit Points = Punkte bewerken
Center point is outside the pad = Middelpunkt liegt außerhalb des Pads
Hole should be inside the pad = Gat moet sich innerhalb des Pads befinden
Hole is draggable = Gat is ziehbar
 
#My Part Tree Menu
Clone = Klonen
Reload parts = Onderdelen opnieuw laden
Layers = Lagen
 
#Dialog Preferences
Language = Taal
Display Name = Weergave naam
HotKey Sync = HotKey-Synchronisering
My Theme Sync = Mijn Theme-Synchronisering
Document Recovery Setting = Instelling voor die Documentwiederherstellung
Enable auto backup = Automatisch opslaan activeren
Maximum backup level = Maximaal backup-nivo
Auto backup interval = Interval voor automatisch opslaan
minutes = Minuten
Save to Server = Op de Server opslaan
Load from Server = Van Server Laden
 
 
#Dialog Schematic Library Wizard
Symbol Wizard = Symboolassistent
Style = Stil
Picture = Afbeelding
Pin Names = Pin Naamn
Contributor = Mitwirkende
contributor = mitwirkende
owner = Eigenaar
 
#Dialog Annotate
Annotate = Kommenteren
Scope= Toepassingsgebied
All pages = 
Current page only = 
 Nur aktiver Schema
Selected components = 
All Opened Schematics = Alle geopende schema's
Method = Werkwijze
Re-annotate all = Alle Opnieuwkommenteren
Keep existing annotation = Existerende Opmerkingene beibehalten
Direction = Richtung
Rows = Rijen
Cols = Kolommen
Reset = Herstel
 
#Dialog Order
Order... = Bestellen...
PCB Qty. = PCB Aantal
PCB Thickness = PCB Dikte
PCB Dimension = PCB Afmeting
Automatic calculation = Automatische Kalkulation
PCB Color = PCB Kleur
Green = Groen
White = Wit
Blue = Blauw
Red = Rood
Yellow = Geel
Black = Zwart
Purple = Paars
Copper = Koper
Gold = Goud
Silver = Zilver
Surface Finish = Oppervlakte behandeling
Hasl = Hasl
Hasl(Lead Free) = Hasl(Loodvrij)
ENIG = ENIG
 
#Dialog Hot Key config
Restore All Default Shortcuts = Alle Standaard sneltoetsen herstellen
Save Changes = Wijzigingen opslaan
 
 
 
#Dialog Polyline Maybe Wire
To connect electrical elements, please use Wire (W hotkey) and not Line (L hotkey). = Um elektrische Elemente naar verbinden, benutzen Sie graag Leitung (W Schnellstaste) en niet Lijn (L Sneltoets).
 
Anonymous File = Anoniem Bestand
Anonymous File can not be cloned, but you can open it, then save it as a new file. = Anonieme Bestanden kunnen niet gekloond worden. Open het bestan handmatig en sla op dan nieuwe versie.
Free Documents = Gratis documenten
You must close the file before delete it! = U moet het Bestand afsluiten, voor u het kunt wissen!
Offline Project = Offline Project
 
#Message box
Confirmation = Bevestiging
Alert = Alarm
Information = Informatie
information = informatie
Prompt = Prompt
Error = Fout
error = fout
error! = fout!
Warning = Waarschuwing
Imported ok! = Import OK!
Some changes have not been saved. = Wijzigingen zijn nog niet opgeslagen.
Your file hasn't been saved. Please save first! = Bestand niet opgeslagen. Graag eerst opslaan!
Your file hasn't been saved. Are you sure you want to close it? = Wijzigingen zijn nog niet opgeslagen. Echt afsluiten?
Error! Please try again later. = Fout! Graag later opnieuw proberen.
Are you sure you want to reload this page? = Pagina echt opnieuw laden?
Are you sure you want to leave this page? = Pagina echt verlaten?
Confirm Reload = Opnieuw laden bevestigen
Confirm Close = Afsluiten bevestigen
Reload this page = Pagina opnieuw laden
Leave this page = Pagina verlaten
Stay on this page = Op deze pagina blijven
Don't reload = Niet opnieuw laden
No connect flag only can be placed on Pin dot or the wire which is connected one Pin. = Es kan geen "Niet Verbenen" Bezeichner nur op dem Pin of dem Draht platziert worden, der met einem Pin verbonden ist.
can not be placed on the wire which is placing No Connect Flag. = kan niet op dem Draht platziert worden, der den "Niet Verbenen" Bezeichner platziert hat.
The footprint transfer to LCSC library class successfully = De Infotragung der Bauteilgrenfläche in die LCSC-Bibliotheeksklasse war gelukt
Device/Footprint goes into "SMT Device/Footprint Verified" list successfully = Gerät/Bauteilgrenfläche wird gelukt in die Liste "SMT Device/Footprint Verified" opgenommen
 
Load failure! = Fout beim Laden!
Load projects failed = Laden van Projecten mislukt
error info = Foutinformatie
error information = foutinformatie
Guest can't create a new project. Please login! = Gast kan geen nieuw Project aanmaken. Graag inloggen!
Please create a project before you do this! = Maak een nieuw project voor u dit doet!
Add Part success = Onderdeel toevoegen gelukt
Click the new part and then edit it! = Klicken Sie op het opnieuwe Teil en bewerken Sie es dann!
Delete my work = Verwijder mijn werk
Delete my work. (Only deletes it from this list but not from the server) = Verwijder mijn werk. (Alleen uit deze lijst, niet van de Server)
Do you confirm this? = Bevestigt u dit?
Successfully deleted! = Wissen is gelukt!
Successfully Copied! = Kopiëren is gelukt!
Cloning success! = Klonen is gelukt !
Your title is too short! = Uw titel is te kort!
Remove this part = Verwijder dit onderdeel
Find and Jump to ... = Zoek en spring naar …
Please type the prefix, such as U1, R1, C1 = Geef een voorletter aan, zoals U1,R1,C1 etc.
Zoom as 1:1, you can print it and then create artwork for etching the PCB. = Vergrotings op 1:1 instellen, dan kunt u de afdruk van de PCB voor het etsen gebruiken.
Exporting your works! = Exporteer uw werk!
Guests can't import a file. Please login! = Besucher kunnen geen Bestanden importeren, graag einloggen
Please create a project before you import a file! = Graag erzeugen Sie eerst een Project bevor Sie eine Bestand importeren!
Import your LTspice file! = Importeer het LTspice Bestand!
Open LTspice file = LTspice Bestand openen
Open EasyEDA file = 
Please make sure the selected LTspice file is a file saved in LTspice V and above. = Graag stellen Sie sicher, dass die ausgewählte LTspice Bestand eine in LTspice V en höher opgeslagene Bestand ist.
Saved successfully! = Opslaan is gelukt!
Save failed! = Opslaan mislukt!
Can not place parts into this document. = Es kunnen geen Teile in dit Document eingefügt worden.
User Package = Gebruikers pakket
System Package = Systeem pakket
File error = Bestandfout
Please save your file first! = Sla het bestand eerst op!
Email address is too short! = email adres is te kort!
You have not selected a file to upload. = Sie haben geen Bestand zum Hochladen ausgewählt.
Update = Bijwerken
No changes, the PCB already matches the schematic! = Geen wijzigingen, de PCB komt al overeen met het schema!
Only public files can be shared = Alleen openbare bestanden kunnen gedeeld worden
Conversion to PCB has failed! = Conversie naar PCB is mislukt!
Your username is too short! = Gebruikersnaam is te kort!
Your password is too short, it must be more than 6 characters! = Wachtwoord is te kort, het moet meer dan 6 Tekens lang zijn!
Conflicting shortcut = Widersprüchliche Verknüpfung
There is an empty PCB file. Please first run Convert Schematic to PCB... from the schematic = Dies is eine leere PCB Bestand. Graag starten Sie eerst „Project naar PCB umwandeln…“ van het Schema aus
This file has been modified, are you sure you want to run this simulation before saving it first? = Diese Bestand is geändert, sind Sie sicher het Sie dit Simulatie starten möchten? Vielleicht moetn Sie Sie erst opslaan?
Please enter the Maximum Timestep! = Graag geben Sie den maximalen Tijdschritt ein!
Please enter the Stop Time! = Graag geben Sie die Stop Tijd ein!
All of these fields are needed. = Alle velden zijn nodig.
Either your spice netlist is too big or the server is busy. Please try again later. = Entweder Uw Spice Net lijst is naar groß of der Server is überlastet. Graag proberen Sie later noch einmal.
Your spice netlist is too big! Try breaking your circuit into smaller simulatable blocks. = Uw Spice Net lijst is naar groß! Versuchen Sie Uw Schaltung in kleinere simulierbare Blöcke naar unterteilen.
Too many users in simulation. Please try again later! = Te veel gebruikers in de simulatie. Probeer het later nog een keer!
Due to limited server resources, please wait 10 seconds for the interval in every time simulation. = Opgren begrenzter Serverressourcen warten Sie graag bij jeder Tijdsimulatie 10 Sekenen op het Intervall.
Your circuit is too complex, we have not enough CPU resource to support this simulation, please reduce your circuit as small as you can. = Uw Schaltung is naar komplex, wir haben niet genügend CPU-Ressourcen, um dit Simulatie naar unterstützen. Graag reduzeren Sie Uw Schaltung so klein wie möglich.
Simulation is queuing, try again after 30s. = Simulatie is in der Warteschlange, proberen Sie es naar 30 Sekenen eropnieuwt.
Timeout = Timeout
Demo accounts don't support simulation, please login first = Demokonten unterstützen geen Simulatie, graag melden Sie sich eerst an
Please login first = Graag eerst aanmelden
The schematic is showing errors, please check the simulation report carefully! = Het Schema zeigt Fout, graag prüfen Sie den Simulatiesrapport sorgfältig!
Simulation too long, maybe your schematic is too complex. = Simulatie is naar lang, es kan zijn het die Schaltung naar komplex ist.
Non-simulated file = Niet simulierte Bestand
This file can only be opened in standard mode. To open it, please switch to standard mode. = Diese Bestand kan nur in het Standardmodus geöffnet worden. Um es naar openen, wisselen Sie graag in den Standardmodus.
Load your preferences success! = Uw instellingen worden gelukt geladen !
Save your preferences success! = Uw instellingen worden gelukt opgeslagen !
Update subckt ok! = Aktualisering des (Onder)Schaltsymbols ok !
Clone your file = Klonen Sie Uw Bestand
Please type a new file name = Graag geben Sie einen nieuw Bestandnaamn ein
Create file failure! = Bestanderzeugung mislukt!
Schematics and PCBs can't be imported under My Libs folder, please choose a different folder = Schaltpläne en PCB kunnen niet in het Map My Libs importiert worden, graag wählen Sie einen andere Map
Libraries to be imported under My Libs folder = Bibliotheken müssen in „Mijn Bibliotheken“ Map importiert worden
Please choose only the libraries needed = Graag wählen Sie nur die Bibliotheken die Sie benötigen
Maximum import is 200 libs at one time! = Maximal 200 Bibliotheken zur gleichen Tijd importeren
You libraries will be found under the My Libs folder = Uw Bibliotheken finden Sie in „Mijn Bibliotheken“ Map
Add to Library = Zu Bibliotheek toevoegen
No items have been checked! = Es worden geen Artikel geprüft!
Nothing was found, please create it for yourself = Es is niets gevonden, graag erzeugen Sie dit selber
Search result = Zoekresultaat
At least 3 characters needed = Er zijn tenminste 3 tekens nodig
Add to my Favorite Parts = Aan mijn favoriete onderdelen toevoegen
Added it OK. Please find it in your Favorite Parts = Erfolgreich hinzugefügt. Graag suchen Sie Sie in Uwn „Bevorzugten Delen“
Please select its parent node = Graag wählen Sie den Hauptnetzknoten
Libraries can not be exported as active project pdf. = Bibliotheken kunnen niet wie aktive Project PDFs exportiert worden.
Error:No GND = Fout: Geen GND
This circuit does not have GND. Please select GND from the circuit tool to add to the circuit. = Deze schakeling heeft geen GND. Kies GND uit het schakeling gereedschap en voeg het toe aan de schakeling.
Current circuit doesn't has Voltage Resource or Current Resource symbol, please place it first at left side EElib or Spice Library. = De stroomkring heeft geen spanningsbron of spanningsbron-symbool, plaats het op de linger pagina van de EElib of van de Spice Bibliotheek.
Probe can not connect with ground(GND)! = Sonde kan niet met Massa (GND) verbonden worden!
Spice symbols's properties can't be empty. = De eigenschappen van Spice Schakelsymbolen mogen niet leeg zijn.
Error:No Spice Symbol = Fout:Geen Spice Schaltsymbol
Simulation limit = Simulatiesgrens
There is a multimeter in the circuit that needs to be simulated using the emulation command .tran or .op = In der Schaltung befindet sich een Multimeter, het met dem Emulationsbefehl .tran of .op . simuliert worden muss
An oscilloscope exists in the circuit and needs to be simulated using the simulation command .tran = 
There are components in this circuit that do not have a simulation model. Please use the base library component of the simulation mode for simulation. = Es gibt Componenten in dieser Schaltung, die geen Simulatiesmodell haben. Graag verwenden Sie voor die Simulatie die Basisbibliothekskomponente des Simulatiemode.
Circuit does not have a probe = Schaltung hat geen Meßspitze
Make sure your pin numbers are even numbers = Stellen Sie sicher het die Pinummern gerade sind
Duplicate Components Prefix = Doppelte Componenten Vorsilbe
All components are hidden successfully! = Alle Componenten worden gelukt ausgeblendet!
All ratlines are hidden successfully! = Alle Verdrahtungslinien worden gelukt ausgeblendet!
Hidden the ratline of net {netName} successfully! = Versteckten van Verdrahtungslinie Net {netNaam} gelukt!
Duplicate Component Prefix = Doppelte Componenten Vorsilbe
{0} exist = {0} bestaat
Modify successfully, but {0} already exists = 
There are some invalid packages, are you sure? = Es gibt einige ungeldige Pakete, sind Sie sicher ?
Invalid Characters, library only allows [0-9a-zA-Z-_] = Ongeldige Tekens, Bibliotheek erlaubt nur [0-9a-zA-Z-_]
Annotation success = Anmerkung gelukt
If you accept this annotation operation, please save your files. If not, close your files without saving. = Wenn Sie die Änderung dieser Anmerkung akzepteren, opslaan Sie graag Uw Bestand. Wenn niet, afsluiten Sie dit Bestand ohne naar opslaan.
This file can't be saved under libs project. Please choose other project or create a new project = Dit bestand kan niet in het libs Project opgeslagen worden. Kies een ander Project of maak een nieuw Project
Your file is unsaved. = Bestand is niet opgeslagen.
You can close the editor now. Have a good day! = U kunt de Editor nu afsluiten. Nog een prettige dag gewenst!
Successfully logged out = Uitloggen gelukt
You have at least one unsaved file open. Please save it or close it. = Er is ten minste één niet opgeslagen bestand open. Graag opslaan of afsluiten.
Please select a reference point = Kies een referentiepunt
Please save your file before this operation = Sla het bestand op voor deze handeling
Please open a PCB document = Open een PCB Document
Please save your file before '{0}'. = Graag opslaan Sie Uw Bestand vor '{0}'.
Please try again after saving this file. = Versuchen Sie es nochmal naardem Sie die Bestand opgeslagen haben.
This text can not be empty! = Deze Text mag niet leeg zijn!
Export to Altium fail, please try again or contact us. = Export naar Altium mislukt, graag proberen Sie es eropnieuwt of kontakteren Sie uns.
Connecting to server = Verbinden zum Server
Please login before asking for help = Graag loggen Sie sich eerst een bevor Sie naar Help fragen
This file has been modified, please save it first! = De Bestand is verändert, graag opslaan Sie Sie eerst!
Remove this param = Entferne diesen Parameter
You cannot drag a part to the canvas, please click the part and move the cursor to the canvas and then right-click to place. = Sie kunnen een Teil niet op die Tekening ziehen, klicken Sie graag op het Teil, bewegen Sie den Cursor op die Tekening en klicken Sie dan met der rechten Muistaste, um es naar plaatsen.
Undo/Redo temporary error = Rückgängig/Wiederaanmaken vorübergehender Fout
We are sorry but there is an unpredictable error in the undo/redo process. This problem will be fixed soon but in the meanwhile it is safe to continue working on your design. = Es tut uns leid, aber beim Rückgängig-/Wiederaanmaken Vorgang is een unvorhersehbarer Fout opgetreten. Dit Problem wird in Kürze behboven, aber in der Zwischenzeit kunnen Sie sicher weiter an de Design arbeiten.
The schematic has duplicate prefixes of the components, please make them unique. You can check them using the Design Manager. = Het Schema hat doppelte Vorsilben der Componenten, graag machen Sie sie eindeutig. Sie kunnen sie met dem Design Beheer controleren.
Found duplicated prefix components, can not Import Changes, please modify the duplicated prefix or delete related component. = Doppelte Vorsilben an Componenten gevonden, Wijzigingen kunnen niet importiert worden. Graag wijzigen Sie die doppelten Vorsilben of wissen Sie die zugehörige Componenten.
Please click the below help button to find out how to fix this problem. = Graag klicken Sie op die onder stehende Helpschaltfläche, um naar erfahren, wie Sie dit Problem beheben kunnen.
Please create a board outline! Click the help button to find out how to create a board outline. = Graag aanmaken Sie eine PCB Umriss! Klicken Sie op die Schaltfläche Help, um naar erfahren, wie Sie eine PCBkontur aanmaken.
Can not fetch files from server, please check your network and try again = Bestanden kunnen niet van het Server abgerufen worden. Graag controleren Sie Ihr Netwerk en proberen Sie es eropnieuwt
Please open a schematic first! = Graag eerst einen Schema openen!
Can not find the schematic of this PCB = Kan den Schema dieser PCB niet finden
invalid points! = ungeldige Punkte!
This file does not support this operation. = Diese Bestand unterstützt diesen Vorgang niet.
Net Name Conflict = Konflikt met einem Netnaamn
Net name = Netnaam
{0} are in the same wire, please remove others and just keep one. = {0} befinden sich in der selben Leitung, graag verwijderen Sie andere en behalten Sie nur eine.
This field can't be removed! = Dit veld kan niet verwijderd worden.
Annular ring of the pad/via is too small = Ring des Pads/Durchkontaktering is naar klein
The size of the hole cannot exceed the size of the pad = De Grootte des Lochs mag die Grootte des Pads niet überschreiten
Are you sure you want to create a multi-sheet designs? = Möchten Sie echt een Design met mehreren Pagina's aanmaken?
Are you sure you want to create a {0}multi-sheet designs{1}? = Möchten Sie echt een {0}Design met mehreren Pagina's{1} aanmaken?
Please build the copper area! Click the help button to find out how to build the copper area. = Graag den Kopergebied bauen! Klicken Sie op die Schaltfläche Help, um naar erfahren, wie Sie den Kopergebied aanmaken.
Suggest to set a package for this component first! = Schlagen Sie vor, eerst een Paket voor dit Componenten festzulegen!
Please select an opened document first. = Graag wählen Sie eerst een geöffnetes Document aus.
Some files failed to load. Please reload the page. = Enkele Bestanden kon niet geladen worden. Graag laden Sie die Pagina opnieuw.
 
#UI Intro
Skip = Overslaan
« Back = « Terug
Next » = Verder »
Done = Klaar
This is the user management menu. = Das is het Benutzerverwaltungsmenü.
This is the toolbar. = Dies is die Symboolleiste.
This is the navigation list. Under here you can find projects, files, parts and libraries. = Das is die Navigationsleiste. Hier kunnen Projecte, Bestanden, Teile en Bibliotheken gevonden worden.
Show or hide the toolbar to the top of the window here. = Blenden Sie hier die Symboolleiste boven in het Fenster een of aus.
Show, resize or hide the left sidebar to the left of the window here. = Zeigen Sie hier die linke Pagina'sleiste links van het Fenster an, wijzigen Sie die Grootte of blenden Sie sie aus.
Show or hide the right sidebar to the right of the window here. = Hier die rechte Pagina'sleiste rechts neben dem Fenster ein- of ausblenden.
 
#Standard libs
Passive Components = Passive Componenten
Power Supply = Stroomverzorging
Diodes = Dioden
Regulator = Spanningsregelaar
Transistor = Transistoren
Transformers = Transformatoren
Gates = Gates
Vacuum Tubes = Vacuum Buizen
Switch = Schakelaar
Relay = Relais
Capacitor(US) = Condensator(US)
Capacitor(EU) = Condensator(EU)
Capacitor(EU)2 = Condensator(EU)2
Electrolytic Capacitor(US) = Elektrolyt Condensator(US)
Electrolytic Capacitor(EU) = Elektrolyt Condensator(EU)
Electrolytic Capacitor(US)2 = Elektrolyt Condensator(US)2
Electrolytic Capacitor(EU)2 = Elektrolyt Condensator(EU)2
Inductor(US) = Spoel(US)
Inductor(EU) = Spoel(EU)
Potentiometer_US = 
Potentiometer_EU/IEC = 
Potentiometer_3D = 
Resistor(US) = Weerstand(US)
Resistor(EU) = Weerstand(EU)
Resistor 45 Deg(US) = Weerstand 45 Grad(US)
Resistor 45 Deg(EU) = Weerstand 45 Grad(EU)
Variable Capacitor(US) = Variabele Condensator(US)
Variable Capacitor(EU) = Variabele Condensator(EU)
Variable Resistor(US) = Variabele Weerstand(US)
Variable Resistor(EU) = Variabele Weerstand(EU)
Variable Inductor(US) = Variabele Spoel(US)
Variable Inductor(EU) = Variabele Spoel(EU)
Varistor = Varistor
Inductor2(US) = Spoel2(US)
Inductor2(EU) = Spoel2(EU)
Battery = Batterij
Voltage Source = Spanningsbron
Current Source = Stroombron
CCCS(Current Controlled Current Source) = CCCS(Stroom kontrollierte Stroombron)
CCCS2(Current Controlled Current Source) = CCCS2(Stroom kontrollierte Stroombron)
VCCS(Voltage Controlled Current Source) = VCCS(Spannings kontrollierte Stroombron)
VCVS(Voltage Controlled Voltage Source) = VCVS(Spannings kontrollierte Spanningsbron)
CCVS(Current Controlled Voltage Source) = CCVS(Stroom kontrollierte Spanningsbron)
CCVS2(Current Controlled Voltage Source) = CCVS2(Stroom kontrollierte Spanningsbron)
 
BV(Behavioral Voltage Sources) = BV(Verhaltensabhängige(Spanning) Spanningsbron)
BI(Behavioral Voltage Sources) = Bi(Verhaltensabhängige(Stroom) Spanningsbron)
Epoly(Non-linear Voltage Source) = Epoly(Niet lineare Spanningsbron)
Gpoly(Non-linear Current Source) = Gpoly(Niet lineare Stroombron)
 
Diode = Diode
LED = LED
LED_3D = LED_3D
Schottky Diode = Schottky Diode
Varactor Diode = Varactor Diode
Zener = Zener
Unidirectional TVS Diode = Unidirectional TVS Diode
Bidirectional TVS Diode = Bidirectional TVS Diode
Diac = Diac
Bridge = Brug
78XX = 78XX
79XX = 79XX
LM317 = LM317
LM337 = LM337
TL431 = TL431
BJT(NPN) = BJT(NPN)
BJT(PNP) = BJT(PNP)
MOSFET(Nch) = MOSFET(Nch)
MOSFET(Nch) Depletion Four-pins = MOSFET(Nch) Depletion Four-pins
MOSFET(Nch) Enhancement = MOSFET(Nch) Enhancement
MOSFET(Nch) Enhancement Four-pins = MOSFET(Nch) Enhancement Four-pins
MOSFET(Pch) = MOSFET(Pch)
MOSFET(Pch) Depletion Four-pins = MOSFET(Pch) Depletion Four-pins
MOSFET(Pch) Enhancement = MOSFET(Pch) Enhancement
MOSFET(Pch) Enhancement Four-pins = MOSFET(Pch) Enhancement Four-pins
JFET(Nch) = JFET(Nch)
JFET(Pch) = JFET(Pch)
Darlington NPN = Darlington NPN
Darlington PNP = Darlington PNP
MESFET(Nch) = MESFET(Nch)
MESFET(Pch) = MESFET(Pch)
 
IGBT = IGBT
SCR = SCR
Triac = Triac
Transform(US) = Transformator(US)
Transform(EU) = Transformator(EU)
Transfrom(NEUTRAL-CTR TAP)(US) = Transformator(NEUTRAL-CTR TAP)(US)
Transfrom(NEUTRAL-CTR TAP)(EU) = Transformator(NEUTRAL-CTR TAP)(eu)
Mutual Inductors = Mutual Inductors
Mutual Inductors2 = Mutual Inductors2
Or Gate = Or Gate
Xor Gate = Xor Gate
And Gate = And Gate
Nor Gate = Nor Gate
Nand Gate = Nand Gate
Not Gate = Not Gate
Xnor Gate = Xnor Gate
Tube Diode = Buizendiode
Tube Triode = Buizentriode
Tube Tetrode = Buizentetrode
Tube Pentode = Buizenpentode
Voltage Controlled Switch = Spanninggestuurde Schakelaar
Current Controlled Switch = Stroomgestuurde Schakelaar
SPST ON = SPST AAN
SPST OFF = SPST Uit
Fuse = Zekering
555 = NE555
555(Style2) = NE555-2
Speaker = Luidspreker
XTAL = Kwarts
5pin Operational Amplifier = 5pin Opamp
3pin Operational amplifier = 3pin Opamp
Transmission Line = Transmissie lijn
Voltmeter = Spanningsmeter (V)
Ammeter = Stroommeter (A)
LAMP = Lamp
Opto Transistor = Opto Transistor
 
#Server Message
Need login = Aanmelding gelukt
Bad password = Fout wachtwoord
We can't find your username or your email, please check it! = Wir kunnen Uwn Benutzernaamn of Uw email-Adresse niet finden, graag controleren Sie es!
Make sure your uploaded file size is less than 3MB! = Stellen Sie sicher, dass die Grootte Uwr hochgeladenen Bestand weniger dan 3 MB beträgt!
Bad file type = Ongeldig bestandstype
Empty file or bad file type, ensure your file is Eagle 6.0+ = Leere Bestand of fouthafter Bestandtyp, stellen Sie sicher, dass Uw Bestand Eagle 6.0+ ist
This operation not supported on demo account = Deze Vorgang wird van het Demokonto niet unterstützt
Can not share this file under a private project, please set the active project to public! = Kan dit Bestand niet unter einem privaten Project teilen, graag instellen Sie het aktive Project op öffentlich!
Login Failed Too many attempts. If you forgot your password, please {0}reset your password{1} or send an email to support@easyeda.com = Anmeldung mislukt Zu viele Versuche. Wenn Sie Ihr Passwort vergessen haben, {0}setzen Sie Ihr Passwort zurück{1} of senden Sie eine email an support@easyeda.com
 
#Dialog Common Buttons
Common Buttons Setting = Allgemeine Toetsninstelling
Menu Setting... = Menu instelling...
Show/Hide = Weergeven / verbergen
Move Up = Naar boven verplaatsen
Move Down = Naar onder verplaatsen
Reset All = Alles herstellen
Zoom = Zoomen
Place Pin = Pin plaatsen
 
#System Setting Dialog
System = Systeem
Zoom Mode = Zoom Modus
Scroll Key = Scroll Toets
CTRL + Scroll = CTRL + Scroll
Canvas Coordinate System = Zeichungs Coördinatensystem
SVG Coordinate = SVG Coördinate
Cartesian Coordinate = Kartesische Coördinaten
Open Wizard Dialog for New Schematic = Open Wizard Dialoog voor nieuw schema
Default Unit = Standaard eenheid
Canvas Zoom Effect = Zoom Effekt
Quality Priority = Qualitätspriorität
Speed Priority = Snelheid prioriteit
Rotation Step = Rotatie stap
Add Teardrop Automatically = Kegelvorm automatisch toevoegen
Assign Net for Free Track/Arc/Circle = Net voor freie Leiterbahn/Boog/Kreis zuweisen
Open Wizard Dialog for New PCB = Assistentendialog voor opnieuwe PCB openen
Rebuild Plane Automatically = Laag automatisch opnieuw opbouwen
The Track's Routing Follows Component's Rotation = Das Routing der Leiterbahn folgt der Rotatie der Componenten
Display Pad's Number and Net = Nummer en Net des Pads weergeven
Favorite Track width = Voorkeur spoorbreedte
Track Width Setting = Instelling spoorbreedte
 
 
#Dialog Access Control
Permissions = Rechten
Operations = Betrieb
Access Control = Toegangsbeheer
Project Access Control = Projectzugriffskontrolle
Reject = Afwijzen
Add User = Gebruiker toevoegen
Bad email address = Onjuist email adres
 
#error info from backend
Can't find this email address in EasyEDA. Your partner must be an EasyEDA user. = Diese email-Adresse kan in EasyEDA niet gevonden worden. Ihr Partner muss een EasyEDA-Benutzer zijn.
 
#Dialog waveForm
Grid Background = Gitter Hintergren
Pane Background = Venster achtergrond
WaveForm Config = Golfvorm Konfiguration
Export Waveform = Golfvorm exporteren
 
 
#attr-canvas-grid-style
dot = Punt
line = Lijn
 
#attr-canvas-frame-size
Other = Andere
A4 Portrait = A4 Portrait
A4 Landscape = A4 Landscape
A3 Portrait = A3 Portrait
A3 Landscape = A3 Landscape
A2 Portrait = A2 Portrait
A2 Landscape = A2 Landscape
A1 Portrait = A1 Portrait
A1 Landscape = A1 Landscape
Landscape = Landscape
Portrait = Portrait
 
#Stroke Style
solid = Vast
dashed = Gearceerd
dotted = Gestippeld
 
#Solid Region
Solid Region = Solid Region
Type = Type
type = type
 
#Dialog Libs Management
Report error = Fout melden
Please give us some information to help us find the problem. = Graag geben Sie uns einige informatie, die uns helfen, het Problem naar finden.
Cannot place parts into this document: Schematic Symbols can only be placed into a Schematic; PCB Footprints can only be placed into a PCB. = Teile kunnen niet in dit Document eingefügt worden: Schemasymbole kunnen nur in einen Schema eingefügt worden; PCB-Grenflächen kunnen nur in einer PCB platziert worden.
Save it as a favorite part = Als Lieblingsteil opslaan
Only logged-in users can save this component as a Favorite Part but guest (Anonymous) users can place this component into their design directly. Would you like to place this component now? = Nur angemeldete Benutzer kunnen dit Componenten als Lieblingsteil opslaan, aber Gastbenutzer (anonym) kunnen dit Componenten direkt in ihr Design einfügen. Möchten Sie dit Bauteil jetzt plaatsen?
 
#Others
Find libs = Zoek Bibliotheek
My Projects = Mijn Projecte
My Parts = Mijn Teile
My Modules = Mijn Module
Assembly LCSC Components = Montage van LCSC-Componenten
Modules = Module
SCH Module = Schema Module
PCB Module = PCB Module
System IC = Systeem IC
LCSC (Official) = LCSC (Officieel)
LCSC Electronics = LCSC Electronics
Simple Mode = Eenvoudige mode
Expand Mode = Uitgebreide mode
Help Verify = Help bij der Infoprüfung
Favorite Parts = Favoriete onderdelen
Shared With Me = Met mij gedeeld
Preview = Voorbeeld
Preview Window = Voorbeeld venster
System Default = Systeem Standard
User Defined = 
Theme = Thema
Theme Setting = Thema Instelling
Close = Sluiten
Open = Openen
Toggle toolbar = 
Toggle left bar = 
Toggle right bar = 
Reload = Opnieuw laden
Mouse-X = Muis-X
Mouse-Y = Muis-Y
Mouse-DX = Muis-DX
Mouse-DY = Muis-DY
Bus entry x1 = Databus Ingang x1
Bus entry x2 = Databus Ingang x2
Bus entry y1 = Databus Ingang y1
Bus entry y2 = Databus Ingang y2
Yes = Ja
No = Nee
OK = OK
Confirm = Bevestigen
Continue = Doorgaan
Cancel = Annuleren
Update = Bijwerken
Bus entry = Databus ingang
Filter = Filter
Check = Controleren
Share my work = Delen
Share it by e-mail, IM, blog, etc. = Delen via email, IM, blog, etc.
 
Copy the contents of this box into a text editor, then save the file. Paste the edited text back into this box and click Apply to update the display. = Kopieer Sie den Inhalt dit Felds in einen Texteditor en opslaan Sie die Bestand. Fügen Sie den bearbeiteten Text wieder in dit Feld een en klicken Sie op Infonehmen, um die Anzeige naar bijwerken.
Copy the contents of this box into a text editor, then save the file with a .svg extension. You can edit it in Inkscape or open it in your browser. = Kopieer Sie den Inhalt dit Felds in einen Texteditor en opslaan Sie die Bestand met der Erweiterung .svg. Sie kunnen es in Inkscape bewerken of in de Browser openen.
Content is too big to show, you can download it directly. = Het Inhalt is naar groß zum weergeven, Sie kunnen ihn direkt downloaden.
SVG format = SVG Formaat
SVG File = SVG Bestand
Description should be no more than 250 letters = De Beschreibung moet niet meer dan 250 Buchstaben umfassen
The file save operation has timed out. Try again and check your Internet connection. = Het Vorgang zum Opslaan der Bestand is abgelaufen. Versuchen Sie es eropnieuwt en controleren Sie Uw Internetverbinding.
Export Netlist = Net lijst exporteren
Notifications = Benaarrichtigungen
Please select txt or json files. = Graag wählen Sie txt- of json-Bestanden aus.
Please select EasyEDA files. = 
Failed to read file [{file}] = Fout bij lezen van bestand [{file}]
[{file}] is not a valid json file = [{file}] is geen geldige JSON-Bestand
Invalid parameters! = Ongeldige Parameter!
Download = Downloaden
Start = Start
You have unsaved files, are you sure you want to log out without saving the files? = Sie haben niet opgeslagene Bestanden. Möchten Sie sich echt abmelden, ohne die Bestanden naar opslaan?
Please use the web version to run this function. = Graag verwenden Sie die Webversion, um dit Functie auszuführen.
Please save this file to you project! = Graag opslaan Sie dit Bestand in de Project!
Nothing changed = Niets hat sich geändert
Delete Node = Knoten wissen
This layer is invisible. = Diese Lage is unsichtbar.
When the solid region is Board Cutout, please set the layer to Multi-Layer. = Wenn der einfarbige Bereich een PCB Ausschnitt ist, stellen Sie die Ebene graag op Multi-Layer ein.
You should not try to assign a net to a Board Cutout solid region. = Sie moetn niet proberen, einem einfarbigen Bereich des PCB Ausschnitts een Net zuzuweisen.
Net Length = Nettolänge
You can place a Pin in the schematic, but don't forget to group all of the Pins to a schematic component. Please click the help button to find out how to group them. If you just want to mark the wire, please use NetPort or NetLabel. = Sie kunnen einen Pin in het Schema plaatsen, aber vergessen Sie niet, alle Pins naar einer Schemakomponente naar grupperen. Graag klicken Sie op die Help-Schaltfläche, um naar erfahren, wie Sie sie grupperen kunnen. Wenn Sie nur den Draht markeren möchten, verwenden Sie graag NetPort of NetLabel.
Please input the modification = Graag geben Sie die Änderung ein
The content must be between {0} and {1} characters = Het Inhalt muss tussen {0} en {1} Tekens lang zijn
 
Coming soon = In Vorbereitung
No tool = Geen Werkzeug
Help us translate into your language = Helfen Sie uns, in Uw Sprache naar übvervangen
Pad = Pad
Via/Hole = Durchkontaktering/Loch
PCB Layers = PCB Lagen
Order PCB = Bestel PCB
Share = Delen
Free = gratis
Small = Klein
Medium = Middel
Big = Groot
 
 
Embed = Embed
HTML = HTML
URL = URL
BBCode = BBCode
PNG = PNG
Exporting as = Exporteren als
Exporting as image = Exporteren als Afbeelding
Exporting as {0}SVG{1} file. = Exporteren als {0}SVG{1} Bestand.
Exporting as pdf is recommended: pdf gives good quality printed output and a small file size. = Het Export als PDF wird empfohlen: PDF liefert eine gute Druckqualität en eine geringe Bestandgröße.
Generate PCB Fabrication File(Gerber) = Genereren einer PCB Fertigungsbestand (Gerber)
PenWidth-Increase = Stiftbreite-Erhöhung
 
#Generate Gerber
Generate Gerber = Gerber genereren
Gerber View = Gerber weergeven
Dimensions(Estimated) = Afmetingen (geschat)
PCB Qty = PCB aantal
Copper Weight = Koper dikte
PCB Price = PCB Prijs
Estimated Delivery Time = Verwachte levertijd
 
HASL(with lead) = HASL(met Lood)
LeadFree HASL-RoHS = Loodfrei HASL-RoHS
ENIG-RoHS = 
Would you like to do Design Rule Checking (DRC) before generating the Gerber files? = Möchten Sie vor dem Genereren der Gerber-Bestanden een Designregelprüfung (DRC) durchführen?
Yes, Check DRC = Ja, Designregeln (DRC) prüfen
No, Generate Gerber = Nee, Gerber genereren
This PCB has uncompleted connection(s), do you want to check the connection(s)? = Diese Platine hat onvolledige Verbindingen. Möchten Sie die Verbinding(en) controleren?
Yes, Check Connection(s) = Ja, Verbinding(en) prüfen
It will then redirect to the web site of a third-party JLCPCB with which we cooperate. Are you ready? = Es wird dan op die Website eines Drittanbieters van JLCPCB weitergeleitet, met dem wir zusammenarbeiten. Sind Sie bereit?
Failed to submit your order, please contact us via support@easyeda.com for help. = Uw Bestelling kon niet gesendet worden. Graag kontakteren Sie uns über support@easyeda.com, um Help naar erhalten.
Failed to submit your order, please contact us via QQ 800821856. = Uw Bestelling kon niet gesendet worden. Graag kontakteren Sie uns über QQ 800821856.
Order data generated finish, please click OK button and continue. = Bestelldaten genereren is beendet, graag op OK klicken en fortfahren.
[generateGerber] 
Layers = Lagen
[/generateGerber] 
 
[version] 
Switch = Schakelaar
[/version] 
 
 
Export your file, then print it yourself. = Exporteren Sie Uw Bestand en drucken Sie sie dan selbst aus.
Trace width is too small = spoor breedte is naar klein
Share = Teile
 
Images Property = Afbeelding Eigenschappen
Connect Pad to Pad = Vebinde Pad naar Pad
Copper Area = Kopergebied
Dimension = Afmeting
 
 
Please check that you have used Wire and not Line to connect electrical elements. = Graag vergewissern Sie sich, dass Sie Leitung en niet Lijn verwendet haben, um elektrische Elemente anzuafsluiten.
PCB Fabrication Prices & capabilities = PCB-Fertigung Prijse & Möglichkeiten
Flip all texts on bottom layer = Alle Texte op der unteren Lage spiegeln
Create New Document = Nieuw Document aanmaken
General Package = Allgemeines Paket
General Packages = Allgemeines Paket
favorite Package = Bevorzugtes Paket
Board Cutout = PCB Ausschnitt
Surface Mount = Oberflächenmontage
JLCPCB Part Class = JLCPCB Teile Klasse
base = Basis
expand = Erweitert
recommend = Empfohlen
Basic Part = Basis Teil
Extended Part = Erweitertes Teil
Recommended Part = Empfohlenes Teil
smtWeld = smt Schweißen
thtWeld = tht Schweißen
manualWeld = manuell Schweißen
furnaceWeld = Ofen Schweißen
Multi-Layer = Meerlagig
Markdown Syntax = 
Markdown supported = 
Read only = Schreibgeschützt
Read/Write = Lesen/Schreiben
More Libraries... = Weitere Bibliotheken...
Decompress failed! = Dekomprimeren mislukt!
Load failed! = Laden mislukt!
Loading = Wird geladen
No Result = Geen Ergebnis
 
#Dialog Place Pin in schematic warning
Place Pin in schematic warning = Pin in Schemawarnung plaatsen
You can place a Pin in schematic, but don't forget to group all of the Pins to a schematic component, please click the help button to find out how to group them. If you just want to mark the wire, please use NetPort or NetNabel. = Sie kunnen einen Pin in het Schema plaatsen, aber vergessen Sie niet, alle Pins naar einer Schemakomponente naar grupperen. Klicken Sie graag op die Help-Schaltfläche, um herauszufinden, wie Sie sie grupperen kunnen. Wenn Sie nur die Leitung markeren möchten, verwenden Sie graag NetPort of NetLabel.
I know. Do not show this again. = Ich weiss. Diese Mitteilung niet meer weergeven.
 
#Extensions Setting
Extensions Setting = Instelling voor uitbreidingen
Remove = Verwijderen
Disable = Deactiveren
Enable = Activeren
(Disabled) = (niet actief)
(Enabled) = (actief)
Load Extension = Laat uitbreidingen
Enable or disable will be applied after reload page = Aktiveren of deaktiveren wird angewendet, naardem die Pagina opnieuw geladen wurde
Your browser cannot run this function. = Ihr Browser kan dit Functie niet ausführen.
Your browser mode does not support indexedDB. Some features may not work properly. Are you using Private Browsing Mode? = Ihr Browsermodus unterstützt indexedDB niet. Enkele Functieen funktioneren möglicherweise niet richtig. Verwenden Sie den privaten Browsermodus?
Extension Files = Uitbreiding bestanden
Extension ID = Uitbreiding ID
Select Files = Kies bestanden
 
#Scripts
Script = Script
Scripts = Scripts
Script Content = Script inhoud
Load from js file = Laad uit js-bestand
UTF-8 encoded js file = UTF-8 gecodeerd js bestand
Description = Beschrijving
description = beschrijving
Not a *.js file = Geen *.js-Bestand
Failed to read file = Bestand kon niet worden gelezen
System scripts cannot be modified = Systeem scripts kunnen niet aangepast worden
Create Subfolder = Submap aanmaken
Create Script = Script aanmaken
Install Script = Script installeren
Install = Installeren
Desktop Client = 
Are you sure you want to remove this script? = Möchten Sie dit Script echt verwijderen?
Folder Name = Mapnaam
Rename = Naam wijzigen
Please select a script = Kies een script
Failed to load script = Fout bij laden van het script
Run Script = Script uitvoeren
Load Script = Script laden
Title is required = Titel is verplicht
Script content is required = Script inhoud is noodzakelijk
System Scripts = Systeemscripts
User Scripts = Gebruikersscripts
You can right click on the tree nodes. = Sie kunnen met der rechten Muistaste op die Baumknoten klicken.
 
#PCB photoView toolbar
Top Side = Bovenkant
Bottom Side = Onderkant
With Silk Layer = Mit Beschriftungslage
No Silk Layer = Ohne Beschriftungslage
Photo View = Fotoweergave
 
#check update
Check Update = Aktualisering controleren
EasyEDA Editor {ver} is released. Would you like to switch to the new version now? = EasyEDA Editor {ver} wird veröffentlicht. Sie möchten jetzt op die opnieuwe Versie umsteigen?
LCEDA Editor {ver} is released. Would you like to switch to the new version now? = LCEDA-Editor {ver} wird veröffentlicht. Sie möchten jetzt op die opnieuwe Versie umsteigen?
Switch to New Version = Wisselen naar de nieuwe versie
Next Time = Volgende keer
 
#download project dialog
Generating download link... = Download-Link wird erstellt...
Download project now = Project jetzt downloaden
 
#Import DXF
Import DXF = DXF importeren
Apply Unit = Einheit toepassen
Convert circle to HOLE on BoardOutLine layer = Kreis in LOCH op BoardOutLine-Lage umwandeln
No shapes found = Geen vormen gevonden
Fail to load the file = Fout beim Laden der Bestand
Please select a DXF file. = Graag wählen Sie eine DXF-Bestand aus.
This feature only works for PCB document. = Diese Functie funktioniert nur voor PCB-Documente.
Select a DXF file = Selecteern Sie eine DXF-Bestand aus
 
#Export DXF
Export DXF = DXF exporteren
Plated-Through-Hole Pads = Beschichtete Durchgangsloch Pads
Non-Plated-Through-Hole Pads = Niet beschichtete Durchgangsloch Pads
Silkscreen = Beschriftungslage
Surface Pad = Oberflächen-Pad
 
#Data Sync
Data Sync = Datensychronisation
Data Conflicts = Datenkonflikte
Project or Document = Project of Document
Cloud-Side = Pagina Cloud
Local-Side = Pagina Lokal
Decision = Beslissing
Modified = Gewijzigd
Deleted = Verwijderd
As Cloud = Als Cloud
As Local = Als Lokaal
Skip = Infospringen
Data sync completed = Datensynchronisatie abgesloten
 
#Team
Team = Team
Teams = Teams
Switching team = Team wisselen
Switch team failed = Kon Team niet wisselen
Load team info fail! = Kon Teaminfo niet laden!
Load team info fail! Please reload. = Kon Teaminfo niet laden! Graag opnieuw laden.
My Teams = Mijn Teams
Create Team = Team aanmaken
 
#Dialog Footprint Manager
Footprint Manager = Beheer Bauteilgrenflächen
Open Footprint Manager = Öffne Bauteilgrenflächen Verwalter
Schematic Components = Schema Componenten
Edit Pin Map Information = Pin-Map-informatie bewerken
Package Categories = Paketkategorien
Components List = Componentenliste
Personal = Persönlich
Component PIN information = Componenten PIN-Info
Footprint PAD information = Grenfläche PAD-Info
Footprint Categories = Kategorien Grenfläche
Pad Number = Padnummer
Search Footprint = Nach Bauteilgrenfläche suchen
Select Footprint = 
Search 3D Model = 
Select 3D Model = 
Filter by keyword = Nach Schlüsselwort filtern
System Libs = Systeembibliotheken
 
#dialog global delete
Drawings = Tekeningen
Netlabel and netFlag = Netlabel en netFlag
Texts = Texte
Wires = Leitungen
Board outlines = PCBkontur
Footprints = Bauteilgrenflächen
Footprint = Bauteilgrenfläche
Tracks = Sporen
 
#dialog board outline settings
Current Size = Momentane Grootte
Paramenters = Parameters
Start X: = Start X:
Start Y: = Start Y:
Round Rectangular = Rond Rechthoekig
radius = Straal
only number is allowed! = alleen een getal toegestaan!
please input valid value of width! = geef een geldige waarde voor de breedte in!
please input valid value of height! = geef een geldige waarde voor de hoogte in!
please input valid value of radius! = geef een geldige waarde voor de straal in!
 
#cross probe
The object you selected was not found in other documents. = Das van Ihnen ausgewählte Object is in andere Documenten niet gevonden.
No valid object for cross probe selected. = Geen geldiges Object voor Meßspitze ausgewählt.
Can not probe. Refreshing the window may get it to work. = Kan niet Meten. Das Bijwerken des Fensters kan dazu führen, dass es funktioniert.
You need to login for this function to work. = Sie müssen sich aanmelden, damet dit Functie funktioniert.
 
#About Dialog
An Easier EDA Experience = 
Version = 
BuiltDate = 
 
#Auto Router Dialog
Auto Router Config = Configuratie Autorouter
General Options = Algemene opties
All Layers = Alle Lagen
Configure = Configureren
Sorry, your web browser does not support this feature. Please run a modern browser. = Functie wird durch den huidigen Browser niet untersützt. Graag Browser wisselen.
Please make sure all objects with net are inside the board outline! = Graag sicaanmaken dass alle Objecten met einem Net innerhalb der Platine (BoardOutline) sind!
Cannot start again before previous activity is stopped = Eine vorige Aktie steht noch aus
Please select a net = Graag een Net selecteren
TrackWidth cannot be empty = spoor breedte mag niet Leer zijn
Clearance cannot be empty = Afstand mag niet Leer zijn
Router is time out. = Tijdüberschreitung während dem Routing.
Server is busy, please try again later. = Server is ausgelastet, graag later eropnieuwt proberen.
Due to the limitation of {0}router server{1} resources, multiple routers executing concurrently are not supported, please try again later or do it manually :-) = Opgren der Beschränkung der {0}Router-Server{1}-Ressourcen worden mehrere gleichzeitig ausgeführte Router niet unterstützt. Graag proberen Sie es later eropnieuwt of tun Sie es manuell :-)
Track Width is invalid = spoor breedte is ongeldig
General Clearance is invalid = Allgemeiner Afstand is ongeldig
SMD Clearance is invalid = SMD-Afstand is ongeldig
Diameter is invalid = Diameter is ongeldig
Drill Diameter is invalid = Boor diameter is ongeldig
Track width cannot be less than Design Rule Checking (DRC) setting value. = spoor breedte mag niet kleiner dan in den Designregeln (DRC) definierte Waarde zijn.
General Clearance cannot be less than Design Rule Checking (DRC) setting value. = Allgemeiner Afstand mag niet kleiner dan in den Designregeln (DRC) definierte Waarde zijn.
SMD Clearance cannot be less than Design Rule Checking (DRC) setting value. = SMD-Afstand mag niet kleiner dan in den Designregeln (DRC) definierte Waarde zijn.
Hole size cannot be less than Design Rule Checking (DRC) setting value. = Lochgrösse mag niet kleiner dan de in den Designregeln (DRC) definierte Waarde zijn.
Design Rule's via diameter must be larger than via drill diameter = Durchkontakterings Druchmeter in den Designregeln (DRC) muss grössere dan Durchkontakterings Boor diameter zijn.
Clearance cannot be less than Design Rule Checking (DRC) setting value. = Afstand mag niet kleiner dan de in den Designregeln (DRC) definierte Waarde zijn.
Not a valid PCB, please check it again = Geen geldige PCB, graag controleren.
Previous connection must be closed = Vorherige Verbinding muss gesloten worden
Network error. Please try again. = Netwerkfout, graag later eropnieuwt proberen.
Router error. = Routerfout.
Invalid PCB. = Ongeldige PCB
General Clearance = Genereller Afstand
SMD Clearance = SMD-Afstand
#Ripup Nets =
Skip Routed Nets = Geroutete Nete überspringen
Remove Existing Tracks = Existerende Leiterbahnen verwijderen
Real-time Display = Anzeige (Echtzeit)
Router Layers = Routerlagen
Via = Durchkontaktering
Special = Speciaal
Special Nets = Speciale Netten
Skip Nets = Netten overslaan
Router Server = Server voor Router
Local = Lokaal
Cloud = Cloud
Available = Beschikbaar
Unavailable = Niet beschikbaar
Checking = Infoprüfe
Install Local Auto Router = Auto Router lokaal installeren
Checking local auto router server... = Infoprüfe lokalen Autorouter Server
Stop Router = Router stoppen
Auto Router is running... = Autorouter werkt...
 
#Left Siderbar
Commonly Library = 
 
Basic = Basis
Extend = Erweitern
Design Manager = Design Beheer
Library = Bibliotheek
Spice Library = Spice Bibliotheek
Shared = Geteilt
LCSC = 
LCSC Parts = LCSC-Teile
Supply Flag = Versorgungsmakering
US = 
EU/IEC = 
US Style = US Stil
Resistor = Weerstand
Capacitor = Condensator
Inductor = Inductie
Switch/Key = Schakelaar/Toets
EU/IEC Style = EU/IEC Stil
CN = 
Connector = Verbinder
Switch/Relay = Schakelaar/Relais
JLCPCB = 
Recycle Bin = Prullenbak
 
#Protractor
Font Height = Lettertypehöhe
Precision = Präzision
Protractor = Hoekmeter
 
#attr-pcbtext-line-width
Only default font family supports to change font width. = Nur die Standardschriftfamilie unterstützt het Wijzigen der Schriftbreite.
Font is missing! You can confirm the dialog and use default font instead or cancel the dialog then upload your font and do it again. = Lettertype fehlt! Sie kunnen het Dialogfeld bevestigen en stattdessen die Standardschriftart verwenden of het Dialogfeld Annuleren, dan Uw Lettertype hochladen en es eropnieuwt tun.
 
#Common
Owner = Eigenaar
License = Licentie
Part Pins = Teil-Pins
Part Properties = 
Net Pins = Netpins
Net Ratlines = Netleitungen
Add Parameter = Parameter toevoegen
Histories record = Historienauftekening
Create Team = Team aanmaken
Can't find this footprint on the server, please re-associate it. = Kan dit Bauteilgrenfläche op dem Server niet finden, graag opnieuw zuordnen.
The footprint name associated with the component and the footprint name on the server are inconsistent, please re-associate it. = Het met der Componenten verbondene Bauteilgrenflächennaam en der Bauteilgrenflächennaam op dem Server sind inkonsistent, graag opnieuw zuordnen.
The symbol pin number(s) of the component does not match the associated footprint pad number(s), please modify the symbol pin number(s) or re-associate the footprint = De Schaltzeichen Pinnummer(n) der Componenten stimmen niet met der/den zugeordneten Bauteilgrenflächen-Pad-Nummer(n) überein, graag wijzigen Sie die Schaltzeichen Pinnummer(n) of ordnen Sie die Bauteilgrenfläche opnieuw zu
No footprint, please associate the footprint first. = Geen Bauteilgrenfläche, graag eerst die Bauteilgrenfläche zuordnen
Can't find the package = Kan het Paket niet finden
The path is for the project URL identify, it is unique (the identity of the project owned by the user cannot be the same) = Het Pfad dient zur Identifizering der Project-URL, er is eindeutig (die Identität des Projects, het dem Benutzer gehört, kan niet identisch zijn)
It's with a letter or a number and can contain only numbers, letters, line-through, underscores, and points. It cannot be modified after saving. = Es besteht aus einem Buchstaben of einer Zahl en kan nur Zahlen, Buchstaben, Durchstriche, Onderstriche en Punkte enthalten. Sie kan naar dem Opslaan niet geändert worden.
Updating document to new format, please wait......After finishing please save your document with Ctrl + S. = Bijwerken des Documents op een opnieuwes Formaat, graag warten......Nach Abschluss opslaan Sie Ihr Document graag met Strg + S.
Open at current project? = Bei huidigem Project openen?
Please select a history to recover. = Graag wählen Sie einen wiederherzustellenden Verlauf aus.
Be careful! When you click the "Recover" button, this sheet will be overwritten! = Vorsichtig zijn! Wenn Sie op die Schaltfläche "Wiederaanmaken" klicken, wird dit Blatt überschrieben!
Recover = Wiederherstellung
There is no PCB under this project, would you like to create one? = Es gibt geen PCB unter diesem Project, möchten Sie eine aanmaken?
Please make sure that the chose Altium Designer files are saved as ASCII files. = Graag stellen Sie sicher, dass die ausgewählten Altium Designer-Bestanden dan ASCII-Bestanden opgeslagen worden.
Export to Altium function is currently in beta: = De Functie "Export naar Altium" befindet sich derzeit in der Beta-Phase:
1. Please be sure to read the notice before exporting: = 1. Graag lesen Sie den Hinweis vor dem Export:
Export Altium notice and disclaimer = Hinweis en Haftungsausschluss zum Export van Altium
2. Please be sure to check again after export! = 2. Graag naar dem Export noch einmal prüfen!
I have read and agree = Ich habe gelesen en stimme zu
Export to Altium = Export naar Altium
Please make sure that the chose Eagle files are saved in Eagle v6.0 and above. = Graag stellen Sie sicher, dass die ausgewählten Eagle-Bestanden in Eagle v6.0 en höher opgeslagen sind.
Please make sure that the Kicad files were compressed as the .zip file. = Graag stellen Sie sicher, dass die Kicad-Bestanden dan .zip-Bestand komprimiert worden.
Open Altium Designer file = Openen Sie die Altium Designer-Bestand
The more information please refer at : = Weitere informatie finden Sie unter:
Please use Gerber file instead of exporting Altium if you are going to do PCB manufacturing. All PCB factories support the Gerber file. Is it ok to Generate the Gerber file? = Graag verwenden Sie die Gerber-Bestand, anstatt Altium naar exporteren, wenn Sie PCB aanmaken möchten. Alle PCB-Fabriken unterstützen die Gerber-Bestand. Ist es in Ordnung, die Gerber-Bestand naar genereren?
Yes, Generate Gerber = Ja, Gerber genereren
No, Export Altium = Nee, Altium exporteren
Open Eagle file = Eagle Bestand openen
Open Kicad file = Kicad Bestand openen
Select file(s) = Bestand(en) selecteren
Append to current project? = Aan huidig Project toevoegen?
Append = Toevoegen
Open as new project = Als opnieuwes Project openen
Tip: Press {0}SPACE{1} or {2}R{3} to rotate the placing object or selected object. = Tipp: Drücken Sie {0}SPACE{1} of {2}R{3}, um het PlatzeringsObject of het ausgewählte Object naar drehen.
Hotkeys Setting = Sneltoetsen Instelling
I know. Don't show this again. = Ich weiß. Zeigen Sie dies niet noch einmal.
Manufacturer Part Number can not be less than 2 characters. = De Fabrikant-Delenummer mag niet weniger dan 2 Tekens lang zijn.
This prefix was changed to non-subpart format. = Diese Vorsilbe is in een Niet-Onderteil-Formaat geändert.
Save as New Project = Als opnieuwes Project opslaan
Save to Existing Project = In bestaandem Project opslaan
Sheet Setting = Pagina Instelling
Sheet Size = Blattgröße
Pre = Voor
pre = voor
Invalid Data = Ongeldige gegevens
Others = Andere
You are not authorized to share this project. = Sie sind niet berechtigt, dit Project naar teilen.
This project is private: if you continue sharing it will be made public. = Dit Project is privat: Wenn Sie met der Freigabe fortfahren, wird es öffentlich gemacht.
Modify file info = Bestandinfo wijzigen
Please input search keyword = Graag Zoekbegriff invoeren
Sort Projects by = Projecten sorteren naar
Date Created = Datum gemaakt
Date Modified = Datum gewijzigd
Title = Titel
Ascending = Oplopend
Descending = Aflopend
Pin to Top = Boven anpinnen
Unpin from Top = Von der Spitze lösen
Collapse / Expand = Inklappen / Uitklappen
Expand = Inklappen
Expand All = Alles Uitklappen
Collapse = Uitklappen
Collapse All = Alles Inklappen
Your file hasn't been saved, do you want to save it? = Uw Bestand is niet opgeslagen. Möchten Sie sie opslaan?
Don't Save = Niet opslaan
Library Owner: = Bibliotheek eigenaar:
verifyPkg.Value = 
State = Status
Please select! = Graag selecteren!
Route = 
Import successfully: = Erfolgreich importeren:
Import failed: = Importeren mislukt:
Path only contain 'a-z、A-Z、- 、 _ 、0-9'! = Pfade enthalten nur 'a-z A-Z 0-9'!
Path must begin as 'a-z、A-Z、0-9'! = Path must begin as 'a-z A-Z 0-9'!
The path length must be between 4~128 characters! = De Pfadlänge muss tussen 4~128 Tekens betragen!
The title length must be between 2 ~ 128 characters. = De Titellänge muss tussen 2~128 Tekens betragen.
Please select an owner = 
Please select obj, wrl or zip file. = 
 Het Titel mag niet weniger dan 3 Tekens umfassen!
Do you want to delete this file? = Möchten Sie dit Bestand wissen?
Add sub part success = Onderteil gelukt toevoegen
Please input name and prefix! = Graag Naam en Vorwahl invoeren!
Board outlines are not closed = Boardumrisse sind niet gesloten
Import failed! The imported files were not ASCII format, please save the files as "Advanced Schematic ascii(*.SchDoc)" or"PCB ASCII File(*.PcbDoc)" at Altium Designer first, and then import. = Altium-Bestand importeren is mislukt, het bestand moet een in UTF-8 gecodeerd tekstbestand zijn.
The Pins "{0}" are not snapped on the grid point! This part maybe will cause some errors in the schematic. = De Pins "{0}" worden niet op Gitter eingerastet! Deze Teil wird möglicherweise einige Fout in het Schema verursachen.
Save failed! Pin number doesn't allow repeat! As below pin number repeat: {0} = 
Check Pin = Pin controleren
Failed to read {0} = Fout bij het lezen van {0}
{0} is invalid = {0} is ongeldig
{0} not found = {0} niet gevonden
Failed to execute script: = Script kon niet worden uitgevoerd worden:
One or more js files not found = Een of meer js-Bestanden niet gevonden
Only ONE {0} file is required = Es is maar één {0} bestand nodig
Extension ID is required = Extension-ID is noodzakelijk
Extension ID is invalid = Extension-ID ongeldig
Extension ID is duplicated = Extension-ID is dubbel
No Result! = Geen Resultaat!
Load Error = Fout bij het laden
loading = Bezig met laden
Failed to load spice data = Spice Daten kon niet geladen worden
Netlist = Net lijst
Tags = Steekwoorden
Pin Information: = Pin-informatie:
Format incorrect, please check for the extra spaces or commas! = Falsches Formaat, graag controleren Sie die zusätzlichen spaties of Kommas!
Round Radius = Afronding Straal
Keyword: = Stichwort:
Image = Afbeelding
Image copied. = Afbeelding kopiert.
Copy failed. = Kopieëren mislukt
Copy success. = 
Image Property = Afbeeldingattribuut
Locked = Gesperrt
Unlock All = Alle freischalten
Unlock = Freischalten
Lock = Sperren
Please input pin name and pin number! = Graag Pin naam en Pin nummer invoeren!
Left-Hand Panel = Linker Paneel
Right-Hand Panel = Rechter Paneel
Update Components from Library = 
 Alle bijwerken
The pin number(s) can't find the same pad number(s) = De Pin-Nummer(n) kunnen niet die gleiche(n) Pad-Nummer(n) finden
Designator = Bezeichner
Replace = Vervangen
Update failed = Bijwerken mislukt
Successfully updated = Bijwerken is gelukt
Update failed! = Bijwerken mislukt!
Successfully updated! = Bijwerken is gelukt!
Successfully updated {0} component(s)! = {0} Componenten(n) bijgewerkt!
Change = Wijzigen
Check Footprints = Bauteilgrenflächen prüfen
Network Error! = Netwerkfout!
Find Similar Objects = Ähnliche Objecten finden
Current Sheet = Huidige Pagina
All Sheets = Alle Pagina's
Kind = Nett
Range = Bereik
Net Label/Net Flag/Net Port/Voltage Probe = Netnaam/Netmakering/Netport/Spanningsmeter
Bezier/Freehand Draw = Bezier/Freihand-Zeichnen
Arc/Pie = Boog/Kuchen
Objects Properties = Objectattribuute
Any = Alle
Same = Hetzelfde
Different = Verschillend
Circular = Rond
Expose Copper = Kupfer freilegen
{0} font is missing. Please add the font to the font family list. = De Lettertype "{0}" fehlt. Graag fügen Sie die Lettertype der Liste der Lettertypen hinzu.
Place Component = Componenten plaatsen
Delete Segment = Segment wissen
Angle = Winkel
Board Thickness = PCB dikte
Layer Distance = Lagenabstand
Silk Screen = Beschriftungslage
Surface Finish Color = Kleur des Oberflächenfinishs
Colors = Kleuren
Board Color = PCB kleur
Board Side = PCB kant
Silk Screen = Opschrift
Silk Screen Color = Kleur opschrift
Display = Weergave
 
#Array and Clone
Distribute Array = Array verteilen
Array Type = Array-Type
Matrix Array = Matrix Array
Circular Array = Cirkel Array
Item Rotation = Artikel rotatie
Location = Locatie
Items per Column = Elementen per Kolom
Items per Row = Elementen per Rij
#Column Spacing =
#Row Spacing =
Spacing(Degrees) = Afstand (Graden)
Start Degree = Start Graden
Rotate Item to Match = Artikel overeenkomend draaien
Clockwise = Met de klok mee
Anti-Clockwise = Tegen de klok in
Distribute by = Verdelen naar
Column = Kolom
Row = Rij
Array Clone = Array-Kloon
Number of Rows = Aantal rijen
Number of Columns = Aantal kolommen
Number of Copies = Aantal Kopieën
Distribute Range(Degrees) = Bereik verdelen (Graden)
 
#Theme color dialog
BusEntry = Databus Einspeisung
Foreground = Voorgrond
Common Used = Vaak gebruikt
Original Theme = Oorspronkelijk thema
Theme Setting = Thema instelling
Change the theme colors of your design = Wijzig de thema kleuren van het onwerp
White on Black = Wit op zwart
Black on White = Zwart op wit
Custom Theme = Aangepast thema
Color Setting = Kleurinstellung
Apply Setting = Instelling toepassen
Theme Setting... = Thema instelling...
Bus Entry = Databus ingang
Foreground = Voorgrond
Symbol Graphics = Schema Grafieken
Common Used = Vaak gebruikt
Draw = Tekenen
Sheet = Pagina
The original theme only works for placing the new symbols. = Het oorspronkelijke thema werkt alleen voor het plaatsen van nieuwe symbolen.
Selection Highlight = Auswahlhervorhebung
Net Label / Port = Netnaam / Port
 
My Theme = Mijn Thema
My Theme Settings = Mijn Thema instellingen
Apply 'Custom Theme' On = „Aangepast Thema“ toepassen op
Creating New Schematic = Maken eines nieuw Schemas
Opening Existed Schematic = Vorhandenen Schema openen
Please fill in all parameters! = Graag alle Parameter invullen!
Convert to Board Cutout = In PCBausschnitt umwandeln
Prefix Position = Vorsilben Positie
Name Position = Naam Positie
Center = Midden
Top = Boven
Bottom = Onder
Left = Links
Right = Rechts
Does not support multiple objects to convert to Board Cutout at the same time = Onderstützt niet mehrere Objecten zum gleichzeitigen Konverteren in Board Cutout
Does not support multiple objects to convert to pad at the same time = Onderstützt niet die gleichzeitige Konvertering mehrerer Objecten in Pad
Convert to Board Cutout = In PCBausschnitt umwandeln
Convert to Pad = In Pad umwandeln
Convert to Component Shape = In Componentenform konverteren
Combine to Continuous Track = Zu kontinuierlichen Leiterbahn kombineren
Convert to Solid Region = In feste Fläche konverteren
Substrate = 
3D View = 3D-Weergave
2D View = 2D-Weergave
Pin Color = Pin Kleur
Name Color = Naam Kleur
Number Color = Nummer Kleur
Dot = Punkt
 
[theme] 
Sheet = Pagina
[/theme] 
 
 
#history dialog
[history-dlg] 
Number = Nummer
Editor = 
[/history-dlg] 
View File History = Versie historie weergeven
Save Time = Opgeslagen op
 
Invalid Format = Ongeldig Formaat
 
#Dialog Teardrop
Round Pad / Via = Rond Pad / Durchkontaktering
Rectangle / Oval / Polygon Pad = Rechthoek / Oval / Polygon Pad
Applying Teardrops = Kegelvorm toepassen
Removing Teardrops = Kegelvorm verwijderen
Waiting = Wachten
Progressing... = Voortgang...
 
No schematic in the project! = Geen Schema in het Project!
 
Move Forward = Vooruit
Move Backward = Achteruit
 
#Dialog Panelize
V-CUT = V-groef
Stamp Hole = Stempelloch
No Panelize = Geen Panelisering
Border and Marking = Rand en Markering
Create Border = Rahmen aanmaken
Border Height = Rahmenhöhe
Border Position = Rahmen Positie
Create Positioning Holes = Positieeringslöcher aanmaken
Create Fiducial Marks = Passermarken aanmaken
Top and Bottom = Boven en onder
Left and Right = Links en rechts
Stamp Hole Group - Column = Stempellochgruppe - Kolom
Stamp Hole Group - Row = Stempellochgruppe - Rij
The number of rows and columns cannot be set to 1 simultaneously = De Aantal der Zeilen en Kolomn kan niet gleichzeitig op 1 gesetzt worden
 
#edit path point
[editPathPoints-dlg] 
Arc(R) = Boog (R)
Type = Typ
Action = Actie
add before = er voor toevoegen
add after = er na toevoegen
delete = wissen
[/editPathPoints-dlg] 
 
#edit polygon point
[editPolygonPoints-dlg] 
Action = Actie
add before = er voor toevoegen
add after = er na toevoegen
delete = wissen
[/editPolygonPoints-dlg] 
You have unconfirmed edit! = Sie haben eine unbestätigte Bearbeitung!
Invalid edit! = Ongeldige Änderung
 
#Dialog PCB Information
PCB Information... = PCB Informatie...
Signal Layers = Signaallagen
None Signal Layers = Niet-Signaallagen
Pads = Pads
Surface Pads = Oberflächliche Pads
Plated Through-hole Pads = Plattierte, durchgebohrte Pads (PTH)
None Plated Through-hole Pads = Niet-plattierte, durchgebohrte Pads (NPTH)
Holes = Löcher
Vias = Durchkontakteringen
Length of Tracks = spoor lengten
Copper Areas = Kopergebieden
 
#Differential Pair Routing
Differential Pair Routing = Differenzielles Paar-Routing
Differential Pair Rule Setting = Instelling der Differenzpaarregel
Please input track width = Graag spoor breedte invoeren
Please input clearance = Graag Afstand invoeren
Routing Rules = Routing-Regeln
 
#Route Length Tuning
Track Length Tuning... = spoor lengten Optimering
Tracks with different net or non-track found in current targets. = Leiterbahnen met unterschiedlichem Net of geen Leiterbahnen in huidigen Zielen gevonden.
Please select the signal tracks to be tuning. = Graag wählen Sie die abzustimmenden Signaalleiterbahnen aus.
The total length exceeds the Design Rule Checking (DRC) constraint, continue ? = De totale Lengte verletzt eine Designregel (DRC) Restriktion. Doorgaan?
45° Angle = 45° Winkel
90° Angle = 90° Winkel
DRC Track Length : = DRC spoor lengte:
Current Length : = Huidige länge:
Additional Length : = Zusätzliche Lengte:
Target Length: = Ziellänge:
Current Length: = Huidige Lengte:
Adjust Type = 
Double Side = 
Single Side = 
 
can not connect to the server = Kan niet met dem Server verbinden
 
#Dialog Copper Area Manager
Copper Area Manager... = Kopergebieden beheren...
Copper Area Manager = Beheer Kopergebieden
Order = Bestelling
Name = Naam
Layer = Laag
Color = Kleur
Net = Net
Move Up = Naar boven
Move Down = Naar onderen
Apply = Toepassen
Cancel = Annuleren
Copper Area do not allow self-intersection! = Kopergebied mag sich niet met zich zelf schneiden!
No copper area! = Geen Kopergebied!
#Dialog report error
Datasheet = Datasheet
Verification = Verificatie
Symbol = Symbool
Pad Number = Padnumber
Pad Size = Padgrösse
Remark = Notities
Correct = Juist
Incorrect = Onjuist
Submit = Verzenden
Tip = Tip
Please select one component = Selecteer één component
Location X = X-Positie
Location Y = Y-Positie
Your current browser version may not support some features. Please use the latest version of Chrome or Firefox, or try the desktop client. = Uw huidige Browserversie unterstützt ggf. einige Functieen niet. Graag op einen modernen Browser of den Desktop-Client wisselen.
EasyEDA Client = EasyEDA Klant
LCEDA Client = LCEDA Klant
Chrome = Chrome
FireFox = Firefox
New Version = Nieuwe Versie
Switch Version = Versie wisselen
Members = Lid
Update Time = Gewijzigd op
Editor = Editor
Current Version = Huidige Versie:
Latest Version = 
Please select a different version to switch; If you want to edit different version in the same time, please open them in different browsers. = Versie zum wisselen selecteren
3D Model = 3D Model
Board Side = PCBseite
Display = Anzeige
Copper = Kupfer
Create New Version = Nieuwe Versie aanmaken
Create new version success! = Nieuwe Versie is gemaakt!
Version Management = Versiesbeheer
Switch success! = Erfolgreich gewechselt!
Please close current version's documents first! = Graag huidige Versie des Documentes eerst afsluiten
Creator = Gemaakt door
Create Time = Gemaakt op
Fail to connect to server! Please check your internet connection status and try again! = Verbinding met dem Server unterbrochen. Graag Verbinding controleren en opnieuw proberen!
Spice Number = Spice Nummer
Create = Maken
3D Outline = 3D-Umriss
Cannot create the slot hole via the board outline, please use the following methods: = Das Langloch kan niet met dem PCBausschnitt erstellt worden, graag verwenden Sie die folgenden Methoden:
Use the solid region and set its type as Board Cutout = Verwenden Sie den ausgefüllten Bereich en legen Sie zijnen Typ dan PCBausschnitt fest
Select a Track/Arc, right-click to use the "Convert to Board Cutout" = Selecteern Sie eine Leiterbahn/einen Boog aus, klicken Sie met der rechten Muistaste, en dan "In PCBausschnitt konverteren".
Select all the closed Tracks/Arcs, right-click to use the "Convert to Board Cutout" = Selecteern Sie alle geslotenen Leiterbahnen/Bögen aus, klicken Sie met der rechten Muistaste, en dan "In PCBausschnitt konverteren"
The more information please refer at = Meer informatie vindt u onder
Save "{0}" success! = "{0}" is opgeslagen!
Save "{0}" failed! = Kon "{0}" niet opslaan!
Invalid Size = Ongeldige Omvang
Processing = Bezig
Invalid Size = Ongeldige Omvang
NetFlag GND = NetFlag GND
NetFlag VCC = NetFlag VCC
NetFlag +5v = NetFlag +5V
No Useful Data! = Unnütze Daten.
SVG Preview = Preview (SVG)
Prefix contains not supported charater(s) ! = Vorsilbe enthält niet unterstützte(s) Tekens!
Name contains not supported charater(s) ! = Naam enthält niet unterstützte(s) Tekens!
Create Grid Path = Gitterpfad aanmaken
Please Input Name = Graag naam invoeren
Building Copper Area = Kopergebied wird erstellt
Processing = Bezig
Opening File = Bestand Openen…
Update from Library = Uit Bibliotheek bijwerken
Update Footprint = Bauteilgrenfläche bijwerken
Update 3D Model = 
Find footprint(s) have been updated, do you want to update? = Bauteilgrenfläche(n) worden bijgewerkt. Bestand ebenfalls bijwerken?
3D File: = Bestand voor 3D-Model:
Model List = Model lijst
Are you sure merge net {0} and net {1}? = Echt Net {0} met {1} zusammenführen?
Display Footprint = Bauteilgrenfläche weergeven
Display Footprint Name While Placing Component = Naam der Bauteilgrenfläche beim plaatsen der Componenten weergeven
Annotate Prefix Automatically After Placing Component = Vorsilbe automatisch naar Platzering einer Componenten beschriften
Program Error, Please Contact Technical Support! = Programmfout, graag technischer Support kontakteren!
Search Engine = Zoekmachine
Keyword to Filter = Nach Schlüsselwort filtern
Normal Mode = Normale Mode
Expand Mode = Uitgebreide Mode
3D Model Manager = Beheer 3D Model
3D Model Preview = Preview 3D Model
3D Model = 3D Model
3DModel = 3DModel
Document = Document
 
[pcblayer] 
3DModel = 3DModel
Document = Document
[/pcblayer] 
 
Adjustment = 
View Larger Image = Grotere Afbeelding weergeven
Previous = Vorige
Previous Image = Vorige Afbeelding
Next Image = Volgende Afbeelding
Notice: For reference only, please refer to the real product = Hinweis: Graag echtes Produkt als Referentie invoeren
It's under designing, please wait. = Es befindet sich in der Entwurfsphase, graag warten Sie.
The width of track/arc/circle cannot be less than 0.1mil! = De Breedte der Leiterbahn/des Boog/Kreises mag niet weniger dan 0.1mil zijn!
Clone success ! = Klonen gelukt!
Footprint Naming Reference = Bauteilgrenfläche-Benennungsreferentie
3D Model Manager = 3D Modelmanager
Will jump to the Lichuang open source hardware platform (OSHWHub.com) to improve the information and share. Whether to continue? = Wird op die Open-Source-Hardwareplattform van Lichuang (OSHWHub.com) springen, um die informatie naar verbessern en naar teilen. Weitermachen?
Will jump to the EasyEDA open source hardware platform (OSHWLab.com) to improve the information and share. Whether to continue? = Springt op die Open-Source-Hardwareplattform EasyEDA (OSHWLab.com) um, um die informatie naar verbessern en naar teilen. Weitermachen?
The project content page will open. After adding a description and setting the project to public, you can click the share button to get the share link. = De Projectinhaltsseite wird geöffnet. Nachdem Sie eine Beschreibung hinzugefügt en het Project dan öffentlich festgelegt haben, kunnen Sie op die Schaltfläche zum Delen klicken, um den Link zum Delen naar erhalten.
This project is not public, can not view homepage! = De Website kan niet angezeigt worden: Dit Project is niet öffentlich.
 
[grid] 
None = Uit
[/grid] 
 
#lib verify and mounted
This component is verified = Diese Componenten is niet verifiziert
This component is unmounted = Diese Componenten is unmontiert
 
#find component
Find Next = Nächste finden
Pin not found = 
Pad not found = 
Object not found = Object niet gevonden
 
#offset Elements
Offset X = X-Offset
Offset Y = Y-Offset
Offset = Offset
Absolute Offset = Absolute Offset
Relative Offset = Relatieve Offset
Absolute Offset... = Absolute Offset...
Relative Offset... = Relatieve Offset...
Reference Point X = X-Referentiepunkt
Reference Point Y = Y-Referentiepunkt
 
#Inner Plane layer
Rebuild Plane = Ebene opnieuw opbauen
PlaneZone Properties = Zonenebene Eigenschappen
Change to a plane layer is not allowed during track routing. = Das Wisseln naar einer Ebenenlage is während des Leiterbahn-Routings niet erlaubt.
#pcblib rect
Fill = Füllen
Fill Type = Fülltyp
[PlaneZone] 
Solid = Vollflächig
[/PlaneZone] 
 
Solid Region do not allow self-intersection! = Vollflächige Regie mag sich niet met zich zelf schneiden.
 
The prefix or name or text too far away from the footprint, if you don't want it to show up please make it hidden. = Vorsilbe, Naam of Texte sind naar weit van der Bauteilgrenfläche verwijderd. Graag manuell ausblenden, falls Sie sie niet weergeven möchten.
The prefixes are not allowed to repeat! = Vorsilben mogen sich niet wiederholen.
Save failed! The origin of the canvas is not in the graphics! Whether to set the origin automatically? = Opslaan mislukt! Het Ursprung der Tekening liegt niet in der Grafiek! Soll der Ursprung automatisch eingestellt worden?
The origin of the canvas has been set in the graphics now, you can save again. = Het Ursprung der Tekening is jetzt in der Grafiek festgelegt, Sie kunnen eropnieuwt opslaan.
Backup Project = Sicherung van het Project anlegen
Open Project Directory = Projectordner openen
 
{0} items updated = {0} Elemente bijgewerkt
 
The current file {0} has an updated version. Do you want to overwrite it? If you want to open the latest version, please close the current file and reopen it. = De huidige Bestand {0} hat eine bijgewerkte Versie. Diese überschreiten? Falls Nee, graag het huidige Document eropnieuwt openen.
Yes, Overwrite It = Ja, überschreiten
No, Keep It = Nee, beibehalten
 
Download Client = Klant downloaden
 
Search tutorial、open source projects etc. = Tutorial doorzoeken, Open-Source-Projecten enz.
 
Go to LCSC and search for = Ga naar LCSC en zoek naar
Go to LCSC = Ga naar LCSC
 
Hide Ratline Layer and Keep the Component Prefix When Paste Objects = Verdrahtungslinie ausblenden en Componentenvorsilbe beim Einfügen van Objecten beibehalten
 
ALL.layer = Alle.Layer
Copper.layer = Kupfer.Layer
Non-Copper.layer = Niet-Kupfer.Layer
Other.layer = Andere.Layer
 
Please enter at least 2 characters! = Graag ten minste twee Tekens invoeren!
View Datasheet = Datasheet weergeven
View Datasheet... = Datasheet weergeven...
 
The corresponding package or network could not be found in the currently open PCB document = Das entsprechende Package of Netwerk kon in het aktuell geöffneten PCB-Document niet gevonden worden
delete fail = Kon niet wissen
 
[crashRecovery] 
Libraries = Bibliotheken
[/crashRecovery] 
Canvas origin anomaly! = Bron der Tekening is fouthaft!
 
Component's Name = Naam (Componenten)
Component's Prefix = Vorsilbe (Componenten)
Component's Footprint = Bauteilgrenfläche (Componenten)
 
[findlib] 
Clear = Wissen
Apply Filters = Filter toepassen
Result = Resultaat
Place = Plaatsen
Prev = Vorige
Next = Volgende
Total {count} Count = Aantal: {count}
About = Info
Items = Elementen
[/findlib] 
 
Object = Object
Layers and Objects = Lagen en Objecten
All = Alle
 
Add custom = Eigene toevoegen
 
Connections = Verbindingen
Attempted: = Geprobeerd:
Completed: = Gemaakt:
Failed: = Mislukt:
Total Vias: = Aantal Durchkontakteringen:
 
Please confirm moving option = Graag bevestigen Sie die Umzugsoption
Only this pad = Nur dit Pad
For this component = Voor dit Componenten
View Owner = Eigenaar weergeven
View Detail = Details weergeven
 
 
#place batch vias
Place Vias = Durchkontakteringen plaatsen
Placing Vias = Durchkontakteringen worden platziert
Removing Vias = Durchkontakteringen worden verwijderd
Batch Vias for Copper = Durchkontakteringen voor Kupfer abarbeiten
Add/Remove Vias = Durchkontakteringen toevoegen/verwijderen
Diameter = Diameter
Drill Diameter = Boor diameter
Column Spacing = Afstand Kolomn
Row Spacing = Afstand Rijn
Multiple vias have been placed, do you want to rebuild the copper area? = Es worden mehrere Durchkontakteringen platziert, möchten Sie den Kopergebied opnieuw opbauen?
Remove vias finish, do you want to rebuild the copper area? = Durchkontakteringen verwijderen is beendet, möchten Sie den Kopergebied opnieuw opbauen?
The width of track/arc/circle cannot be less than 0.051mm/2mil/0.002inch! = De Breedte der Leiterbahn / des Boogs / des Kreises mag niet weniger dan 0,051 mm / 2 mil / 0,002 Zoll betragen!
Save fail! Please try again! = Opslaan mislukt! Graag versuche es eropnieuwt!
Please select a copper outline = Graag wählen Sie eine Kupferkontur
Can't find copper area at other layers, please add the copper area with the same net at other layer first. = Kan Kupferfläche op andere Lagen niet finden, fügen Sie graag eerst die Kupferfläche met dem gleichen Net op einer andere Lage hinzu.
 
Add favorite success! = Erfolgreich in Favorieten opgenommen.
Remove favorite success! = Erfolgreich aus Favorieten verwijderd!
Remove favorite failed! = Verwijderen aus Favorieten mislukt!
Whether if remove favorite? = Aus Favorieten verwijderen?
Split by ';' for multi tags = Tags met ';' scheiden.
 
This size is the determined size! = Diese Grootte is die ermittelte Grootte!
The associated pad has been locked = Das assoziierte Pad is gesperrt.
Split by space or , for multi tags = Tags met spaties of ',' scheiden.
 
Rotation X = X-Rotatie
Rotation Y = Y-Rotatie
Rotation Z = Z-Rotatie
 
Some fields are filled invalid data = Enkele Felder beinhalten ungeldige Waarden
start time should be earlier than stop time = Startzeit moet früher dan die Stoppzeit zijn
Number of points should be less than 100 in octave variation = De Aantal der Punkte moet weniger dan 100 in der Oktavvariatie betragen
Start frequency should be less than stop frequency. The suffix meg stands for Mega,m stands for milli = Startfrequentie moet kleiner dan Stoppfrequentie zijn. (Suffixe: meg = Mega, m = milli)
Get historical records fail! = Kon historische Einträge niet abfragen!
This 3D model didn't create the outlines successfully, please import it again or contact with us. = Dit 3D-Model hat die Umrisse niet gelukt erstellt. Graag opnieuw importeren of Kontakt met dem Support opnehmen.
There is No Tag! = Es is geen Stichworte definiert.
Assign successful! = Erfolgreich zugewiesen.
Found footprint's pad number doesn't match the schematic component's pin number, please correct the pad number and try again! = De Pad-Nummer der gevonden Bauteilgrenfläche stimmt niet met der Pin-Nummer der Schemakomponente überein. Graag korrigeren Sie die Pad-Nummer en proberen Sie es eropnieuwt!
Update Property = Property bijwerken
Update Properties = 
Please fill in at least 5 words. = Graag ten minste fünf Wörter invoeren
Mouse hovering over the track to highlight the entire network = Das gesamte Net wird hervorgehebt, sobald die Muis über eine Leiterbahn schwebt.
Net Highlighting While Cursor Hover the Track = Net beim schweben über einer Leiterbahn hervorheben.
When circle set as "Yes", the Pin length must be more than 6 = Wenn der Kreis op "Ja" eingestellt ist, muss die Pinlänge meer dan 6 betragen
Hi, I found a problem of your library, this library seems incorrect.\ntitle:{title}\nType:{type}\nlink:{link}\n{content}\nThank you! = Hallo, ich habe een Problem met Uwr Bibliotheek gevonden, dit Bibliotheek scheint falsch naar zijn.\ntitle:{title}\nType:{type}\nlink:{link}\n{content}\nDanke!
 
Logout fail! Please try again! = Fout bij uitloggen! Probeer het opnieuw.
Logout success! We look forward you to use LCEDA again! = Uitloggen gelukt! Tot de volgende keer bij LCEDA!
Logout success! We look forward you to use EasyEDA again! = Uitloggen gelukt! Tot de volgende keer bij EasyEDA!
Click to Preview 3D = 3D-Preview openen
[logoutDialog] 
Logout = Uitloggen
[/logoutDialog] 
 
[findlibTag] 
All = Alle
[/findlibTag] 
 
Export Pick and Place File = Bestand voor Pick-and-Place exporteren
Mirror the bottom component's X coordinate (JLCPCB doesn't need) = Spiegeln Sie die X-Coördinate der unteren Componenten (JLCPCB benötigt dit niet)
Work Space = Werkruimte
Include panelized components' coordinates = Coördinaten der abgeglichenen Componenten einafsluiten
Personal Workspace = Persoonlijke Werkruimte
Work Space - {name} = Werkruimte - {naam}
Work Space - Personal = Werkruimte - Personal
Cloning = Klonung
 
Project Owner = Project Eigenaar
Clone Project = Project klonen
Homepage = Website
Apply for Education Edition = Voor Educatie Editie bewerben
Load Organization failed = Laden van de organisatie mislukt
Joined = Lid geworden
Favorite = Favoriet
This operation will unfavorite this project, do you want to continue? = Dit Project wordt uit de Favorieten verwijderd. Doorgaan?
View Homepage = Website openen
Private Project = Privé Project
3-7 days = 3 bis 7 Tage
Close Tab = Tab afsluiten
Close Other Tabs = Alle andere Tabs afsluiten
Close All Tabs = Alle Tabs afsluiten
Open in New Window = In opnieuwem Fenster openen
Cursor Snap to Component's Origin or Pad Center While Dragging Component = Cursor beim Ziehen der Componenten op Ursprung of Pad-Zentrum der Componenten ausrichten
Undefined = Undefiniert
Input = Eingabe
Model Unit = Modeleinheit
File Unit = Bestandeinheit
This part contains subparts, please make sure you have checked other subparts before reporting error, do you want to continue? = Deze Teil enthält Onderteile. Graag vergewissern Sie sich, dass Sie andere Onderteile überprüft haben, bevor Sie einen Fout melden. Möchten Sie fortfahren?
 
[saveAs] 
Power = Vermogen
[/saveAs] 
 
Assign LCSC Part# = LCSC Partnummer toewijzen
Unexpected error while converting. Perhaps unsupported file type or program bug. = Unerwarter Fout beim Konverteringsprozess.
Found duplicated component IDs, please click "OK" to re-assign component ID automatically, and then save the document and try again. = Duplikate van Componenten-IDs worden detektiert. Graag met "OK" dit Componenten-IDs dynamisch opnieuw zuweisen, het Document opslaan en den Vorgang anafsluitend wiederholen.
 
#electromagneticSimulation
Electromagnetic Simulation... = Elektromagnetische Simulatie...
You will upload Gerber to SuperEM for electromagnetic simulation (only upload Gerber, not including account data), do you want to continue? = Eine Gerber-Bestand (Exklusiv Kontodaten) wird an SuperEM voor eine elektromagnetische Simulatie transferiert. Doorgaan?
SuperEM is a 3-D full-wave electromagnetic simulation and design platform for high-speed PCB circuits and antennas, which is developed by Faraday Dynamics, Ltd. = SuperEM is een 3D Vollgolfn elektromagnetische Simulaties Platform voor Hochgeschwindigkeits PCB Antennen, welche van Faraday Dynamics Ltd. entwickeld wurde.
Visit the SuperEM = SuperEM besuchen
SuperEM User Guide = SuperEM Benutzerhandbuch
Upload Gerber to SuperEM successfully, please click "OK" buttun to continue = Laden Sie Gerber gelukt op SuprEME hoch, klicken Sie graag op die Schaltfläche "OK", um fortzufahren
 
Format = Formaat
View = Weergave
Design = Ontwerp
Simulation = Simulatie
Advanced = Uitgebreid
Fabrication = Fabriceren
Check DRC = Designregelprüfung (DRC) controleren
Simulation Setting = Simulatiesinstellingen
BOM = BOM
PCB Fabrication File(Gerber) = Gerber-Bestand
Pick and Place File = Pick-and-Place Bestand
Parts Order = Onderdelen bestellen
PCB Order = PCB bestellen
One-click Order Parts = 
One-click Order PCB/SMT = 
SIM = SIM
STD = STD
WaveForm = Golfvorm
 
Place Module = Module plaatsen
Please enter identification letters: = Graag Identifzeringszeichen invoeren.
Only support English letters, up to 5. = Nur bis naar 5 englische Tekens worden unterstützt.
 
Exist doesn't annotate prefix component(s) in the module, please edit and annotate the unique prefix(s) for component(s) first. = Exist vergibt geen automatisch beschrifteten Vorsilben and die Componenten(n) in het Modul. Graag bewerken en kommenteren Sie eerst die eindeutigen Vorsilben voor die Componenten(n).
Opening = Opening
 
Also update track's net (Only applies to circumstance under which prefix/netlabel changes and no component/wire is added or removed) = Auch het Net der Leiterbahnen bijwerken (Gilt nur voor Umstände, unter denen sich Vorsilbe/Netnaam ändert en geen Componenten/Leitung hinzugefügt of verwijderd wird)
 
#desktop client error feedback
Cannot open online documents on Project Offline mode. = Online-Documente kunnen in het Project-Offline-Modus niet geöffnet worden.
 
Please select a project = Selecteer een Project
Opened Projects = Geopende Projecten
Open Project = Open Project
Close Project = Project afsluiten
Open All Projects = Alle Projecten openen
Close All Projects = Alle Projecten afsluiten
Select Owner = Selecteer Eigenaar
Select Folder = Selecteer Map
Select Owner or Folder = Selecteer Eigenaar of Map
Select Project = Selecteer Project
Folder = Map
New Folder = Nieuwe Map
New Sub Folder = Nieuwe Submap
Delete Folder = Map wissen
Move Project = Verplaats Project
Move Folder = Verplaats Map
#Rename Folder
Please input the folder name = Naam voor de map
Invalid folder name = Ongeldige naam
Are you sure to delete this folder? = Möchten Sie diesen Map echt wissen?
All projects in this folder will be moved to the root directory. = Alle projecten in deze map worden verplaatst naar de root directory.
Create new folder successfully = Aanmaken nieuwe Map is gelukt
Failed to create new folder = Fout bij het maken van een nieuwe map
Delete folder successfully = Map wissen is gelukt
Failed to delete folder = Map kon niet gewist worden
Rename folder successfully = Map hernoemen is gelukt
Failed to rename folder = Fout bij hernoemen van de map
Move folder successfully = Map verplaatsen is gelukt
Failed to move folder = Map kon niet verplaatst worden
Move project successfully = Project verplaatsen is gelukt
Failed to move project = Project kon niet verplaatst worden
The folder depth must not exceed {0} levels = De diepte van submappen mag niet meer zijn dan {0} nivo's
Failed to add project to folder = Project kon niet aan deze map toegevoegd worden
 
Doesn't support JLCPCB SMT Service = Ondersteunt de JLCPCB SMT-Dienst niet
{0} for JLCPCB SMT Service = {0} voor JLCPCB SMT-Dienst
 
Reset failed! There are duplicate component prefixes in the current schematic: = Herstellen mislukt! Im huidigen Schema gibt es doppelte Componenten Vorsilben
Reset failed! There are duplicate component prefixes in the current PCB: = Herstellen mislukt! Es gibt doppelte Componenten Vorsilben in der huidigen PCB:
Please modify the component prefixes first to ensure that the component prefix is unique. = Graag wijzigen Sie eerst die Componenten Vorsilben, um sicherzustellen, dass die Componenten Vorsilben eindeutig sind.
 
LCEDA(Standard) - A Simple and Powerful Electronic Circuit Design Tool = LCEDA(Standard) - Ein einfaches en vermogensstarkes Design-Tool voor elektronische Schaltungen
EasyEDA(Standard) - A Simple and Powerful Electronic Circuit Design Tool = Ein einfaches en vermogensstarkes Design-Tool voor elektronische Schaltungen
 
#Dialog for Package Custom Data
Please input the data title = Graag Titel voor dit Daten invoeren
Data title duplicated = Daten-Titel is dupliziert
Cannot be more than {0} characters! = Mag niet meer dan {0} Tekens zijn!
Only latin alphabets, digits, underscore(_) and hyphen(-) are allowed. = Nur folgende Tekens sind erlaubt: Lateinisches Alphabet, Nummern, Onderstrich (_), Bindestrich (-)
Invalid value of item {0} = Ongeldige Waarde voor Element {0}
Update DFM = DFM bijwerken
Custom DFM Data = Eigene DFM Daten
Saved custom data successfully! = Benutzerdefinierte Daten worden gelukt opgeslagen!
Save custom data failed! = Benutzerdefinierte Daten kon niet opgeslagen worden
Will replace the graphics and custom data of current document, after imported please adjust the 3D model. Continue or not? = Diese Aktie wird Grafieken en Benutzerdefinierte Daten voor het huidige Document vervangen. Nach Import graag het 3D-Model wieder anpassen. Fortfahren?
Open footprint "Custom Data" dialog = "Benutzerdefinierte Daten" voor dit Bauteilgrenfläche openen.
 
#Create lead shape
Create Lead Shape = Lötform voor Leitung aanmaken
Base on Pad Center = Op Pad Mitte baserend
Base on Canvas Origin = Op Tekenings Ursprung baserend
Lead shape = Lötform
Footprint Type = Bauteilgrenfläche Typ
From pad shape = Von Pad Form
Lead length = Lötleitungsslänge
Lead width = Lötleitungsbreite
Lead diameter = Lötdurchmeter
Scaling ratio = Skaleringsverhältnis
Leads creating direction = Lötausrichtung
Auto = Auto
Horizontal = Horizontal
Vertical = Vertikal
Canvas origin to lead edge = Tekeningsursprung zur Lötkante
Canvas origin to body edge = Tekeningsursprung zur Körperkante
Lead soldering length = Lengte des Lötspur
Lead soldering part diameter = Diameter des Lötteils
Component shape object doesn't overlap lead shape object, please check carefully. = Das ComponentenformObject überlappt het LötformObject niet, graag controleren Sie es sorgfältig.
The solder mask expansion of pads ({0},{1}) has a small clearance(less than 0.08mm), it will cause the soldering too short, please modify. = De Lötmaskenausdehnung der Pads ({0},{1}) hat einen kleinen Afstand (weniger dan 0,08 mm), dadurch wird het Löten te kort, graag wijzigen Sie es.
The paste mask expansion or custom paste mask layer objects of pads ({0},{1}) has a small clearance(less than 0.15mm), it will cause the stencil to create fail, please modify. = De Maskenerweiterungs- of benutzerdefinierten MaskenObjecten der Pads ({0},{1}) haben einen kleinen Afstand (weniger dan 0,15 mm). Dies führt dazu, dass die Schablone fehlschlägt. Graag wijzigen Sie sie.
System footprint must have pad number 1 or A1, please modify the pad number. = Systeem Bauteilgrenfläche muss Pad-Nummer 1 of A1 vorhanden zijn, graag wijzigen Sie die Pad-Nummer.
System footprint doesn't allow two or more pad numbers are 1 or A1, please modify the pad number. = De Systeem Bauteilgrenfläche lässt niet zu, dass twee of meer Pad-Nummern 1 of A1 sind, graag wijzigen Sie die Pad-Nummer.
Document layer has circle object, but jlcPara's polarity is 0, please check the Custom Data. = De Documentenlage hat een KreisObject, aber die Polarität van jlcPara is 0, graag controleren Sie die benutzerdefinierten Daten.
There are exist repeat pad numbers: {padNumber}, please check, if it is correct please ignore this. = Es gibt Wiederholungs-Pad-Nummern: {padNumber}, graag controleren Sie, ob es richtig ist, ignoreren Sie dies bitte.
Can't find the circle at the component marking layer, or this circle doesn't at the same quadrant with the 1st pad, please check whether it is correct. = Kan den Kreis op der Bauteilmarkeringslage niet finden of dieser Kreis befindet sich niet in het gleichen Quadranten met dem 1. Pad, graag controleren Sie, ob er korrekt ist.
 
ROUND = RUND
RECTANGLE = RECHTHOEK
OCTAGONAL = ACHTHOEK
Upper left = Boven links
Lower left = Onder links
Center of Pads = Midelpunt van Pads
First Pin = Eerste Pin
Package Name = Gehäusenaam
Pins Number = Pin Aantal
Rows Of Pin = Pinreihen Aantal
Columns Of Pin = Pinspalten Aantal
Polarity = Polariteit
Pad Shape = Pad-Form
Body Diameter = Körperdurchmeter
Lead Span = Spannweite Lötung
Lead Vertical Span = Vertikale Spannweite Lötung
Body Length = Körperlänge
Body Height = Körpergrösse
Pin Diameter = Pin-Diameter
Pin Length = Pin-Lengte
Pin Height = Pin-Hoogte
Pin Solid Width = Vollflächig Pin Breedte
Pin Solid Height = Vollflächige Pin Hoogte
Pin Spacing = Afstand Pin
Pin Horizontal Spacing = Horizontaler Afstand Pin
Pin Vertical Spacing = Vertikaler Afstand Pin
ThermalPad = Thermisches Pad
Pad Expansion = Ausdehnung Pad
Custom PasteMask = Eigene Maskeringslage
Fabrication Tolerance = Fabricatie tolerantie
Placement Tolerance = Plaatsings tolerantie
FirstPin Position = Positie eerste Pin
Package Origin = Ursprungspunkt Gehäuse
Expansion Size = Verbreitungsgrösse
Corner = Hoek
Angle = Hoek
Fillet = 
Chamfer = Afschuinen
Update Preview = Preview bijwerken
Number of pins (left and right) = Aantal Pins (Links en rechts)
Number of pins (up and down) = Aantal Pins (Boven en onder)
Reference Use Cases = Anwedungsfälle aus Referentie
Package Type = Gehäusetyp
Capacitance = Capaciteit
Resistance = Weerstand
Bidirectional Diode = Bi-Directionele Diode
Inductance = Inductie
Crystal Oscillator = Kristal oscillator
Diode = Diode
LED = LED
Fuse = Zekering
Entity height = Hoogte (Entität)
Lead Overhang = Lötüberhang
Lead Thickness = Lötdicke
Unknown mistake = Unbekannter Fout
Has ThermalVias = Hat Thermische Durchkontakteringen
Polar Capacitance = Polaire Capaciteit
 
Create Component Marking = Bauteilmarkering aanmaken
Create component marking successfully! = Bauteilkenntekening gelukt erstellt!
No elements on component shape layer! = Geen Elemente op Bauteillage
No elements on lead shape layer! = Geen Elemente op der Lötformlage!
No pad of number 1 or A1, please modify the pad number. = Geen Pad der Nummer 1 of A1, graag wijzigen Sie die Pad-Nummer.
Save failed! Component marking circle is at the axis. Do you want to recreate the component marking? = Opslaan mislukt! Bauteilmarkeringskreis befindet sich op der Achse. Möchten Sie die Bauteilkenntekening opnieuw aanmaken?
If autoroute fail, you can export the autoroute file(DSN) to third-party autorouter tool(Such as: FreeRouting, Konekt Electra, Eremex TopoR etc.), and export the session file(SES) after finished autoroute, and then import to PCB. = Wenn Autoroute fehlschlägt, kunnen Sie die Autoroute-Bestand (DSN) in een Autorouter-Tool eines Drittanbieters exporteren (z. B.: Konekt Electra, Eremex TopoR enz.) en anafsluitend exporteren Sie die Sitzungsbestand (SES) naar beendeter Autoroute en importeren Sie sie dan op die PCB.
Auto route failed! Found abnormal pad(s) data, please modify the pad width and height: = Autoroute mislukt! Ungewöhnliche Pad(s)-Daten gevonden, graag wijzigen Sie die Pad Breedte en Hoogte:
Select Properties = Eigenschappen selecteren
Combine the same parts' prefixes in one row = Kombineren Sie die Vorsilben der gleichen Teile in einer Rij
Please check at least one item! = Kies tenminste één element!
Pins = 
Check component latest version when open schematic = 
Only show updated components = 
Note: When a PCB is Import Changes, the PCB is updated according to the footprint version to which the schematic is bound. = 
Doesn't support to import the binary format DXF, please import the ASCII format DXF. = 
 
Find System Similar Footprint = 
Found similar footprints at system library, it is recommended to use them first. = 
Copy Title = Kopieer titel
Check system similar footprint = 
Can't find the Similar Footprint = 
Search failed! = Zoekn mislukt!
No package information! = 
Find Parameters = Zoek Parameters
Find Results = Zoekresultaten
 
Bill of material(BOM) uploaded finish, please click "OK" to continue. = 
Bill of material(BOM) upload failed! = 
 
All pads = Alle pads
All holes = Alle gaten
Single layer pads = 
Multi-layer pads = 
Same X pads = 
Same Y pads = 
Same Y and clearance pads = 
Same X and clearance pads = 
Same X and clearance pads' clearance = 
Same Y and clearance pads' clearance = 
Pad's hole diameter(max) = 
Pad's hole diameter(min) = 
Pad's hole diameter(aver) = 
 
Try Pro Edition = Probeer de Pro editie
 
Generate Solid Region by Objects Outline = 
Generate Polygon Pad by Objects Outline = 
Select the objects that cannot be generated = 
 
Please compress schematic and PCB as a zip file and then import it, if you only import the schematic you need to binding with the footprint manually. = 
Please compress schematic and PCB in ASCII format as a zip file and then import it, if you only import the schematic you need to binding with the footprint manually. = 
Import failed! The imported files were not ASCII format, please save the files as "Advanced Schematic ascii(*.SchDoc)" or"PCB ASCII File(*.PcbDoc)" at Altium Designer first, and then import. = 
The PCB text will use the editor new font family, the text maybe will appear a little excursion. = 
Because of different file format and element, please check carefully after imported. = 
Please make sure the EAGLE file is saved in EAGLE v6.0 and higher version. = 
Please compress schematic and PCB as a zip file by KiCad5 and then import it, if you only import the schematic you need to binding with the footprint manually. = 
Please make sure the Protel file is exported as ASCII format file. = 
Please compress the schematic and corresponding symbols as a zip file and then import it. = 
 
Please save the files as "Advanced Schematic ascii(*.SchDoc)" or"PCB ASCII File(*.PcbDoc)" at Altium Designer first, and then import. = Sla de bestanden in Altium Designer op als "Advanced Schematic ascii(*.SchDoc)" of als "PCB ASCII File(*.PcbDoc)". Probeer de import dan opnieuw.
Tips = Tips
Exists incomplete connection = 
Found that the board has incomplete connection, please check the nets and ratlines = 
creator = Gemaakt door
You are not logged in or the login status is invalid, please login and try again. = U bent niet ingelogd of de login status is onjuist. Log in en probeer het opnieuw.
Display Board Cutout = 
